BD-API-BADPARAM	CppTest	BD-API-BADPARAM
BD-API-CTYPE	CppTest	BD-API-CTYPE
BD-API-NEGPARAM	CppTest	BD-API-NEGPARAM
BD-API-REVNEGPARAM	CppTest	BD-API-REVNEGPARAM
BD-API-STRSIZE	CppTest	BD-API-STRSIZE
BD-API-VALPARAM	CppTest	BD-API-VALPARAM

BD-CO-EMPCON	CppTest	BD-CO-EMPCON
BD-CO-ITINVCOMP	CppTest	BD-CO-ITINVCOMP
BD-CO-ITMOD	CppTest	BD-CO-ITMOD
BD-CO-ITOUT	CppTest	BD-CO-ITOUT
BD-CO-STRMOD	CppTest	BD-CO-STRMOD

BD-MISC-DC	CppTest	BD-MISC-DC
BD-MISC-TRANS	CppTest	BD-MISC-TRANS

BD-PB-ARRAY	CppTest	BD-PB-ARRAY
BD-PB-ARRPTR	CppTest	BD-PB-ARRPTR
BD-PB-BADSHIFT	CppTest	BD-PB-BADSHIFT
BD-PB-BYTEORD	CppTest	BD-PB-BYTEORD
BD-PB-CC	CppTest	BD-PB-CC
BD-PB-CHECKRET	CppTest	BD-PB-CHECKRET
BD-PB-CHECKRETGEN	CppTest	BD-PB-CHECKRETGEN
BD-PB-DEREF	CppTest	BD-PB-DEREF
BD-PB-DNMPTR	CppTest	BD-PB-DNMPTR
BD-PB-EOFCOMP	CppTest	BD-PB-EOFCOMP
BD-PB-ERRNO	CppTest	BD-PB-ERRNO
BD-PB-EXCEPT	CppTest	BD-PB-EXCEPT
BD-PB-EXITHAN	CppTest	BD-PB-EXITHAN
BD-PB-FGETS	CppTest	BD-PB-FGETS
BD-PB-FSETPOS	CppTest	BD-PB-FSETPOS
BD-PB-INFREC	CppTest	BD-PB-INFREC
BD-PB-INTOVERF	CppTest	BD-PB-INTOVERF
BD-PB-INVENV	CppTest	BD-PB-INVENV
BD-PB-INVRET	CppTest	BD-PB-INVRET
BD-PB-MODSTR	CppTest	BD-PB-MODSTR
BD-PB-MCCSTR	CppTest	BD-PB-MCCSTR
BD-PB-NEWHAN	CppTest	BD-PB-NEWHAN
BD-PB-NOEXCEPT	CppTest	BD-PB-NOEXCEPT
BD-PB-NORETDECL	CppTest	BD-PB-NORETDECL
BD-PB-NORETURN	CppTest	BD-PB-NORETURN
BD-PB-NOTINIT	CppTest	BD-PB-NOTINIT
BD-PB-NP	CppTest	BD-PB-NP
BD-PB-NZTS	CppTest	BD-PB-NZTS
BD-PB-OVERFARRAY	CppTest	BD-PB-OVERFARRAY
BD-PB-OVERFFMT	CppTest	BD-PB-OVERFFMT
BD-PB-OVERLAP	CppTest	BD-PB-OVERLAP
BD-PB-OVERFNZT	CppTest	BD-PB-OVERFNZT
BD-PB-OVERFRD	CppTest	BD-PB-OVERFRD
BD-PB-OVERFWR	CppTest	BD-PB-OVERFWR
BD-PB-POLARR	CppTest	BD-PB-POLARR
BD-PB-POVR	CppTest	BD-PB-POVR
BD-PB-PTRARR	CppTest	BD-PB-PTRARR
BD-PB-PTRCMP	CppTest	BD-PB-PTRCMP
BD-PB-PTRSUB	CppTest	BD-PB-PTRSUB
BD-PB-PTRVALUE	CppTest	BD-PB-PTRVALUE
BD-PB-PUTENV	CppTest	BD-PB-PUTENV
BD-PB-RECFUN	CppTest	BD-PB-RECFUN
BD-PB-REFPARAM	CppTest	BD-PB-REFPARAM
BD-PB-SIGHAN	CppTest	BD-PB-SIGHAN
BD-PB-SIGRETURN	CppTest	BD-PB-SIGRETURN
BD-PB-STDEXC	CppTest	BD-PB-STDEXC
BD-PB-STREAMFLAGS	CppTest	BD-PB-STREAMFLAGS
BD-PB-STREAMFMT	CppTest	BD-PB-STREAMFMT
BD-PB-STREAMINOUT	CppTest	BD-PB-STREAMINOUT
BD-PB-SUBSEQFRWD	CppTest	BD-PB-SUBSEQFRWD
BD-PB-SUBSEQMOVE	CppTest	BD-PB-SUBSEQMOVE
BD-PB-SWITCH	CppTest	BD-PB-SWITCH
BD-PB-TERMHAN	CppTest	BD-PB-TERMHAN
BD-PB-UNEXPHAN	CppTest	BD-PB-UNEXPHAN
BD-PB-VALRANGE	CppTest	BD-PB-VALRANGE
BD-PB-VARARGS	CppTest	BD-PB-VARARGS
BD-PB-VCTOR	CppTest	BD-PB-VCTOR
BD-PB-VDTOR	CppTest	BD-PB-VDTOR
BD-PB-VLASIZE	CppTest	BD-PB-VLASIZE
BD-PB-VOVR	CppTest	BD-PB-VOVR
BD-PB-WRAPESC	CppTest	BD-PB-WRAPESC
BD-PB-WRRDSTR	CppTest	BD-PB-WRRDSTR
BD-PB-WRROS	CppTest	BD-PB-WRROS
BD-PB-ZERO	CppTest	BD-PB-ZERO

BD-RES-BADFREEF	CppTest	BD-RES-BADFREEF
BD-RES-CSP	CppTest	BD-RES-CSP
BD-RES-FREE	CppTest	BD-RES-FREE
BD-RES-INSUFMEM	CppTest	BD-RES-INSUFMEM
BD-RES-INVFREE	CppTest	BD-RES-INVFREE
BD-RES-LEAKS	CppTest	BD-RES-LEAKS
BD-RES-BADDEALLOC	CppTest	BD-RES-BADDEALLOC
BD-RES-STACKLIM	CppTest	BD-RES-STACKLIM

BD-TRS-ARG	CppTest	BD-TRS-ARG
BD-TRS-BITLOCK	CppTest	BD-TRS-BITLOCK
BD-TRS-CMF	CppTest	BD-TRS-CMF
BD-TRS-DIFCS	CppTest	BD-TRS-DIFCS
BD-TRS-DLOCK	CppTest	BD-TRS-DLOCK
BD-TRS-DSTRLOCK	CppTest	BD-TRS-DSTRLOCK
BD-TRS-FRC	CppTest	BD-TRS-FRC
BD-TRS-FORKFILE	CppTest	BD-TRS-FORKFILE
BD-TRS-JOINDETACH	CppTest	BD-TRS-JOINDETACH
BD-TRS-LOCK	CppTest	BD-TRS-LOCK
BD-TRS-MLOCK	CppTest	BD-TRS-MLOCK
BD-TRS-ORDER	CppTest	BD-TRS-ORDER
BD-TRS-REVLOCK	CppTest	BD-TRS-REVLOCK
BD-TRS-SYMLINK	CppTest	BD-TRS-SYMLINK
BD-TRS-TSHL	CppTest	BD-TRS-TSHL
