AssignIvarOutsideAccessors	OCLint	ivar assignment outside accessors or init
AvoidBranchingStatementAsLastInLoop	OCLint	avoid branching statement as last in loop
BitwiseOperatorInConditional	OCLint	bitwise operator in conditional
BrokenNilCheck	OCLint	broken nil check
BrokenNullCheck	OCLint	broken null check
BrokenOddnessCheck	OCLint	broken oddness check
CollapsibleIfStatements	OCLint	collapsible if statements
ConstantConditionalOperator	OCLint	constant conditional operator
ConstantIfExpression	OCLint	constant if expression
CoveredSwitchStatementsDontNeedDefault	OCLint	switch statements don't need default when fully covered
CyclomaticComplexity	OCLint	high cyclomatic complexity
DeadCode	OCLint	dead code
DefaultLabelNotLastInSwitchStatement	OCLint	default label not last in switch statement
DoubleNegative	OCLint	double negative
EmptyCatchStatement	OCLint	empty catch statement
EmptyDoWhileStatement	OCLint	empty do while statement
EmptyElseBlock	OCLint	empty else block
EmptyFinallyStatement	OCLint	empty finally statement
EmptyForStatement	OCLint	empty for statement
EmptyIfStatement	OCLint	empty if statement
EmptySwitchStatement	OCLint	empty switch statement
EmptyTryStatement	OCLint	empty try statement
EmptyWhileStatement	OCLint	empty while statement
ForLoopShouldBeWhileLoop	OCLint	for loop should be while loop
GotoStatement	OCLint	goto statement
InvertedLogic	OCLint	inverted logic
JumbledIncrementer	OCLint	jumbled incrementer
LongClass	OCLint	long class
LongLine	OCLint	long line
LongMethod	OCLint	long method
LongVariableName	OCLint	long variable name
MisplacedNilCheck	OCLint	misplaced nil check
MisplacedNullCheck	OCLint	misplaced null check
MissingBreakInSwitchStatement	OCLint	missing break in switch statement
MultipleUnaryOperator	OCLint	multiple unary operator
NPathComplexity	OCLint	high npath complexity
NcssMethodCount	OCLint	high ncss method
NestedBlockDepth	OCLint	deep nested block
NonCaseLabelInSwitchStatement	OCLint	non case label in switch statement
ObjCVerifyIsEqualHash	OCLint	must override hash with isEqual
ObjCBoxedExpressions	OCLint	replace with boxed expression
ObjCContainerLiterals	OCLint	replace with container literal
ObjCNSNumberLiterals	OCLint	replace with number literal
ObjCObjectSubscripting	OCLint	replace with object subscripting
ParameterReassignment	OCLint	parameter reassignment
PreferEarlyExit	OCLint	use early exits and continue
RedundantConditionalOperator	OCLint	redundant conditional operator
RedundantIfStatement	OCLint	redundant if statement
RedundantLocalVariable	OCLint	redundant local variable
RedundantNilCheck	OCLint	redundant nil check
ReturnFromFinallyBlock	OCLint	return from finally block
ShortVariableName	OCLint	short variable name
SwitchStatementsShouldHaveDefault	OCLint	switch statements should have default
ThrowExceptionFromFinallyBlock	OCLint	throw exception from finally block
TooFewBranchesInSwitchStatement	OCLint	too few branches in switch statement
TooManyFields	OCLint	too many fields
TooManyMethods	OCLint	too many methods
TooManyParameters	OCLint	too many parameters
UnnecessaryElseStatement	OCLint	unnecessary else statement
UnusedLocalVariable	OCLint	unused local variable
UnusedMethodParameter	OCLint	unused method parameter
UselessParentheses	OCLint	useless parentheses
