js-constructor-super	eslint	constructor-super
js-for-direction	eslint	for-direction
js-getter-return	eslint	getter-return
js-no-async-promise-executor	eslint	no-async-promise-executor
js-no-case-declarations	eslint	no-case-declarations
js-no-class-assign	eslint	no-class-assign
js-no-compare-neg-zero	eslint	no-compare-neg-zero
js-no-cond-assign	eslint	no-cond-assign
js-no-const-assign	eslint	no-const-assign
js-no-constant-condition	eslint	no-constant-condition
js-no-control-regex	eslint	no-control-regex
js-no-debugger	eslint	no-debugger
js-no-delete-var	eslint	no-delete-var
js-no-dupe-args	eslint	no-dupe-args
js-no-dupe-class-members	eslint	no-dupe-class-members
js-no-dupe-else-if	eslint	no-dupe-else-if
js-no-dupe-keys	eslint	no-dupe-keys
js-no-duplicate-case	eslint	no-duplicate-case
js-no-empty	eslint	no-empty
js-no-empty-character-class	eslint	no-empty-character-class
js-no-empty-pattern	eslint	no-empty-pattern
js-no-ex-assign	eslint	no-ex-assign
js-no-extra-boolean-cast	eslint	no-extra-boolean-cast
js-no-extra-semi	eslint	no-extra-semi
js-no-fallthrough	eslint	no-fallthrough
js-no-func-assign	eslint	no-func-assign
js-no-global-assign	eslint	no-global-assign
js-no-import-assign	eslint	no-import-assign
js-no-inner-declarations	eslint	no-inner-declarations
js-no-invalid-regexp	eslint	no-invalid-regexp
js-no-irregular-whitespace	eslint	no-irregular-whitespace
js-no-loss-of-precision	eslint	no-loss-of-precision
js-no-misleading-character-class	eslint	no-misleading-character-class
js-no-mixed-spaces-and-tabs	eslint	no-mixed-spaces-and-tabs
js-no-new-symbol	eslint	no-new-symbol
js-no-nonoctal-decimal-escape	eslint	no-nonoctal-decimal-escape
js-no-obj-calls	eslint	no-obj-calls
js-no-octal	eslint	no-octal
js-no-prototype-builtins	eslint	no-prototype-builtins
js-no-redeclare	eslint	no-redeclare
js-no-regex-spaces	eslint	no-regex-spaces
js-no-self-assign	eslint	no-self-assign
js-no-setter-return	eslint	no-setter-return
js-no-shadow-restricted-names	eslint	no-shadow-restricted-names
js-no-sparse-arrays	eslint	no-sparse-arrays
js-no-this-before-super	eslint	no-this-before-super
js-no-undef	eslint	no-undef
js-no-unexpected-multiline	eslint	no-unexpected-multiline
js-no-unreachable	eslint	no-unreachable
js-no-unsafe-finally	eslint	no-unsafe-finally
js-no-unsafe-negation	eslint	no-unsafe-negation
js-no-unsafe-optional-chaining	eslint	no-unsafe-optional-chaining
js-no-unused-labels	eslint	no-unused-labels
js-no-unused-vars	eslint	no-unused-vars
js-no-useless-backreference	eslint	no-useless-backreference
js-no-useless-catch	eslint	no-useless-catch
js-no-useless-escape	eslint	no-useless-escape
js-no-with	eslint	no-with
js-require-yield	eslint	require-yield
js-use-isnan	eslint	use-isnan
js-valid-typeof	eslint	valid-typeof
