AbstractClassConstructorCanBeMadeProtected	ReSharper	AbstractClassConstructorCanBeMadeProtected
AccessRightsInText	ReSharper	AccessRightsInText
AccessToDisposedClosure	ReSharper	AccessToDisposedClosure
AccessToForEachVariableInClosure	ReSharper	AccessToForEachVariableInClosure
AccessToModifiedClosure	ReSharper	AccessToModifiedClosure
AccessToStaticMemberViaDerivedType	ReSharper	AccessToStaticMemberViaDerivedType
AddressOfMarshalByRefObject	ReSharper	AddressOfMarshalByRefObject
AmdExternalModule	ReSharper	AmdExternalModule
AngularHtml.Banana	ReSharper	AngularHtml.Banana
AnnotationConflictInHierarchy	ReSharper	AnnotationConflictInHierarchy
AnnotationRedundancyAtValueType	ReSharper	AnnotationRedundancyAtValueType
AnnotationRedundancyInHierarchy	ReSharper	AnnotationRedundancyInHierarchy
ArgumentsStyleAnonymousFunction	ReSharper	ArgumentsStyleAnonymousFunction
ArgumentsStyleLiteral	ReSharper	ArgumentsStyleLiteral
ArgumentsStyleNamedExpression	ReSharper	ArgumentsStyleNamedExpression
ArgumentsStyleOther	ReSharper	ArgumentsStyleOther
ArgumentsStyleStringLiteral	ReSharper	ArgumentsStyleStringLiteral
ArrangeAccessorOwnerBody	ReSharper	ArrangeAccessorOwnerBody
ArrangeDefaultValueWhenTypeEvident	ReSharper	ArrangeDefaultValueWhenTypeEvident
ArrangeDefaultValueWhenTypeNotEvident	ReSharper	ArrangeDefaultValueWhenTypeNotEvident
ArrangeModifiersOrder	ReSharper	ArrangeModifiersOrder
ArrangeObjectCreationWhenTypeEvident	ReSharper	ArrangeObjectCreationWhenTypeEvident
ArrangeObjectCreationWhenTypeNotEvident	ReSharper	ArrangeObjectCreationWhenTypeNotEvident
ArrangeRedundantParentheses	ReSharper	ArrangeRedundantParentheses
ArrangeStaticMemberQualifier	ReSharper	ArrangeStaticMemberQualifier
ArrangeThisQualifier	ReSharper	ArrangeThisQualifier
ArrangeTrailingCommaInMultilineLists	ReSharper	ArrangeTrailingCommaInMultilineLists
ArrangeTrailingCommaInSinglelineLists	ReSharper	ArrangeTrailingCommaInSinglelineLists
ArrangeTypeMemberModifiers	ReSharper	ArrangeTypeMemberModifiers
ArrangeTypeModifiers	ReSharper	ArrangeTypeModifiers
ArrangeVarKeywordsInDeconstructingDeclaration	ReSharper	ArrangeVarKeywordsInDeconstructingDeclaration
Asp.ContentPlaceholderNotResolved	ReSharper	Asp.ContentPlaceholderNotResolved
Asp.CustomPageParserFilterType	ReSharper	Asp.CustomPageParserFilterType
Asp.DeadCode	ReSharper	Asp.DeadCode
Asp.Entity	ReSharper	Asp.Entity
Asp.Image	ReSharper	Asp.Image
Asp.InvalidControlType	ReSharper	Asp.InvalidControlType
Asp.NotResolved	ReSharper	Asp.NotResolved
Asp.ResolveWarning	ReSharper	Asp.ResolveWarning
Asp.SkinNotResolved	ReSharper	Asp.SkinNotResolved
Asp.TagAttributeWithOptionalValue	ReSharper	Asp.TagAttributeWithOptionalValue
Asp.ThemeNotResolved	ReSharper	Asp.ThemeNotResolved
Asp.Warning	ReSharper	Asp.Warning
AspOdsMethodReferenceResolveError	ReSharper	AspOdsMethodReferenceResolveError
AspUnusedRegisterDirectiveHighlighting	ReSharper	AspUnusedRegisterDirectiveHighlighting
AssignNullToNotNullAttribute	ReSharper	AssignNullToNotNullAttribute
AssignToConstant	ReSharper	AssignToConstant
AssignToImplicitGlobalInFunctionScope	ReSharper	AssignToImplicitGlobalInFunctionScope
AssignedValueIsNeverUsed	ReSharper	AssignedValueIsNeverUsed
AssignedValueWontBeAssignedToCorrespondingField	ReSharper	AssignedValueWontBeAssignedToCorrespondingField
AssignmentInConditionExpression	ReSharper	AssignmentInConditionExpression
AssignmentInConditionalExpression	ReSharper	AssignmentInConditionalExpression
AssignmentIsFullyDiscarded	ReSharper	AssignmentIsFullyDiscarded
Asxx.PathError	ReSharper	Asxx.PathError
AsyncIteratorInvocationWithoutAwaitForeach	ReSharper	AsyncIteratorInvocationWithoutAwaitForeach
AutoPropertyCanBeMadeGetOnly.Global	ReSharper	AutoPropertyCanBeMadeGetOnly.Global
AutoPropertyCanBeMadeGetOnly.Local	ReSharper	AutoPropertyCanBeMadeGetOnly.Local
BadChildStatementIndent	ReSharper	BadChildStatementIndent
BadControlBracesIndent	ReSharper	BadControlBracesIndent
BaseMemberHasParams	ReSharper	BaseMemberHasParams
BaseMethodCallWithDefaultParameter	ReSharper	BaseMethodCallWithDefaultParameter
BaseObjectEqualsIsObjectEquals	ReSharper	BaseObjectEqualsIsObjectEquals
BaseObjectGetHashCodeCallInGetHashCode	ReSharper	BaseObjectGetHashCodeCallInGetHashCode
BitwiseOperatorOnEnumWithoutFlags	ReSharper	BitwiseOperatorOnEnumWithoutFlags
BlockScopeRedeclaration	ReSharper	BlockScopeRedeclaration
BuiltInTypeReferenceStyle	ReSharper	BuiltInTypeReferenceStyle
BuiltInTypeReferenceStyleForMemberAccess	ReSharper	BuiltInTypeReferenceStyleForMemberAccess
ByRefArgumentIsVolatileField	ReSharper	ByRefArgumentIsVolatileField
CDeclarationWithImplicitIntType	ReSharper	CDeclarationWithImplicitIntType
CallerCalleeUsing	ReSharper	CallerCalleeUsing
CannotApplyEqualityOperatorToType	ReSharper	CannotApplyEqualityOperatorToType
CenterTagIsObsolete	ReSharper	CenterTagIsObsolete
CheckForReferenceEqualityInstead	ReSharper	CheckForReferenceEqualityInstead.1
CheckForReferenceEqualityInstead	ReSharper	CheckForReferenceEqualityInstead.2
CheckForReferenceEqualityInstead	ReSharper	CheckForReferenceEqualityInstead.3
CheckForReferenceEqualityInstead	ReSharper	CheckForReferenceEqualityInstead.4
CheckNamespace	ReSharper	CheckNamespace
Class	ReSharper	Class
ClassCannotBeInstantiated	ReSharper	ClassCannotBeInstantiated
ClassNeverInstantiated.Global	ReSharper	ClassNeverInstantiated.Global
ClassNeverInstantiated.Local	ReSharper	ClassNeverInstantiated.Local
ClassWithVirtualMembersNeverInherited.Global	ReSharper	ClassWithVirtualMembersNeverInherited.Global
ClassWithVirtualMembersNeverInherited.Local	ReSharper	ClassWithVirtualMembersNeverInherited.Local
ClearAttributeIsObsolete	ReSharper	ClearAttributeIsObsolete
ClearAttributeIsObsolete.All	ReSharper	ClearAttributeIsObsolete.All
ClosureOnModifiedVariable	ReSharper	ClosureOnModifiedVariable
CoVariantArrayConversion	ReSharper	CoVariantArrayConversion
CoercedEqualsUsing	ReSharper	CoercedEqualsUsing
CollectionNeverQueried.Global	ReSharper	CollectionNeverQueried.Global
CollectionNeverQueried.Local	ReSharper	CollectionNeverQueried.Local
CollectionNeverUpdated.Global	ReSharper	CollectionNeverUpdated.Global
CollectionNeverUpdated.Local	ReSharper	CollectionNeverUpdated.Local
CommaNotValidHere	ReSharper	CommaNotValidHere
CommonJsExternalModule	ReSharper	CommonJsExternalModule
CompareOfFloatsByEqualityOperator	ReSharper	CompareOfFloatsByEqualityOperator
ConditionIsAlwaysConst	ReSharper	ConditionIsAlwaysConst
ConditionIsAlwaysTrueOrFalse	ReSharper	ConditionIsAlwaysTrueOrFalse
ConditionalTernaryEqualBranch	ReSharper	ConditionalTernaryEqualBranch
ConfusingCharAsIntegerInConstructor	ReSharper	ConfusingCharAsIntegerInConstructor
ConstantConditionalAccessQualifier	ReSharper	ConstantConditionalAccessQualifier
ConstantNullCoalescingCondition	ReSharper	ConstantNullCoalescingCondition
ConstructorCallNotUsed	ReSharper	ConstructorCallNotUsed
ConstructorInitializerLoop	ReSharper	ConstructorInitializerLoop
ContainerAnnotationRedundancy	ReSharper	ContainerAnnotationRedundancy
ContractAnnotationNotParsed	ReSharper	ContractAnnotationNotParsed
ConvertClosureToMethodGroup	ReSharper	ConvertClosureToMethodGroup
ConvertConditionalTernaryExpressionToSwitchExpression	ReSharper	ConvertConditionalTernaryExpressionToSwitchExpression
ConvertIfDoToWhile	ReSharper	ConvertIfDoToWhile
ConvertIfStatementToConditionalTernaryExpression	ReSharper	ConvertIfStatementToConditionalTernaryExpression
ConvertIfStatementToNullCoalescingAssignment	ReSharper	ConvertIfStatementToNullCoalescingAssignment
ConvertIfStatementToNullCoalescingExpression	ReSharper	ConvertIfStatementToNullCoalescingExpression
ConvertIfStatementToReturnStatement	ReSharper	ConvertIfStatementToReturnStatement
ConvertIfStatementToSwitchExpression	ReSharper	ConvertIfStatementToSwitchExpression
ConvertIfStatementToSwitchStatement	ReSharper	ConvertIfStatementToSwitchStatement
ConvertIfToOrExpression	ReSharper	ConvertIfToOrExpression
ConvertNullableToShortForm	ReSharper	ConvertNullableToShortForm
ConvertSwitchStatementToSwitchExpression	ReSharper	ConvertSwitchStatementToSwitchExpression
ConvertToAutoProperty	ReSharper	ConvertToAutoProperty
ConvertToAutoPropertyWhenPossible	ReSharper	ConvertToAutoPropertyWhenPossible
ConvertToAutoPropertyWithPrivateSetter	ReSharper	ConvertToAutoPropertyWithPrivateSetter
ConvertToCompoundAssignment	ReSharper	ConvertToCompoundAssignment
ConvertToConstant.Global	ReSharper	ConvertToConstant.Global
ConvertToConstant.Local	ReSharper	ConvertToConstant.Local
ConvertToLambdaExpression	ReSharper	ConvertToLambdaExpression
ConvertToLocalFunction	ReSharper	ConvertToLocalFunction
ConvertToNullCoalescingCompoundAssignment	ReSharper	ConvertToNullCoalescingCompoundAssignment
ConvertToStaticClass	ReSharper	ConvertToStaticClass
ConvertToUsingDeclaration	ReSharper	ConvertToUsingDeclaration
ConvertToVbAutoProperty	ReSharper	ConvertToVbAutoProperty
ConvertToVbAutoPropertyWhenPossible	ReSharper	ConvertToVbAutoPropertyWhenPossible
ConvertToVbAutoPropertyWithPrivateSetter	ReSharper	ConvertToVbAutoPropertyWithPrivateSetter
CreateSpecializedOverload	ReSharper	CreateSpecializedOverload
CssBrowserCompatibility	ReSharper	CssBrowserCompatibility
CssCaniuseFeatureRequiresPrefix	ReSharper	CssCaniuseFeatureRequiresPrefix
CssCaniuseUnsupportedFeature	ReSharper	CssCaniuseUnsupportedFeature
CssNotResolved	ReSharper	CssNotResolved
CssObsolete	ReSharper	CssObsolete
CssPropertyDoesNotOverrideVendorProperty	ReSharper	CssPropertyDoesNotOverrideVendorProperty
DeclarationHides	ReSharper	DeclarationHides
DeclarationIsEmpty	ReSharper	DeclarationIsEmpty
DeclarationVisibilityError	ReSharper	DeclarationVisibilityError
DefaultValueAttributeForOptionalParameter	ReSharper	DefaultValueAttributeForOptionalParameter
DlTagContainsNonDtOrDdElements	ReSharper	DlTagContainsNonDtOrDdElements
DoubleColonsExpected	ReSharper	DoubleColonsExpected
DoubleColonsPreferred	ReSharper	DoubleColonsPreferred
DoubleNegationInPattern	ReSharper	DoubleNegationInPattern
DoubleNegationOfBoolean	ReSharper	DoubleNegationOfBoolean
DoubleNegationOperator	ReSharper	DoubleNegationOperator
DuplicateIdentifierError	ReSharper	DuplicateIdentifierError
DuplicateReferenceComment	ReSharper	DuplicateReferenceComment
DuplicateResource	ReSharper	DuplicateResource
DuplicatingLocalDeclaration	ReSharper	DuplicatingLocalDeclaration
DuplicatingPropertyDeclaration	ReSharper	DuplicatingPropertyDeclaration
DuplicatingSwitchLabel	ReSharper	DuplicatingSwitchLabel
DynamicShiftRightOpIsNotInt	ReSharper	DynamicShiftRightOpIsNotInt
ElidedTrailingElement	ReSharper	ElidedTrailingElement
EmptyConstructor	ReSharper	EmptyConstructor
EmptyDestructor	ReSharper	EmptyDestructor
EmptyEmbeddedStatement	ReSharper	EmptyEmbeddedStatement
EmptyForStatement	ReSharper	EmptyForStatement
EmptyGeneralCatchClause	ReSharper	EmptyGeneralCatchClause
EmptyNamespace	ReSharper	EmptyNamespace
EmptyObjectPropertyDeclaration	ReSharper	EmptyObjectPropertyDeclaration
EmptyReturnValueForTypeAnnotatedFunction	ReSharper	EmptyReturnValueForTypeAnnotatedFunction
EmptyStatement	ReSharper	EmptyStatement
EmptyTitleTag	ReSharper	EmptyTitleTag
EntityNameCapturedOnly.Global	ReSharper	EntityNameCapturedOnly.Global
EntityNameCapturedOnly.Local	ReSharper	EntityNameCapturedOnly.Local
EnumUnderlyingTypeIsInt	ReSharper	EnumUnderlyingTypeIsInt
EnumerableSumInExplicitUncheckedContext	ReSharper	EnumerableSumInExplicitUncheckedContext
EqualExpressionComparison	ReSharper	EqualExpressionComparison
ErrorInXmlDocReference	ReSharper	ErrorInXmlDocReference
EventNeverInvoked	ReSharper	EventNeverInvoked
EventNeverInvoked.Global	ReSharper	EventNeverInvoked.Global
EventNeverSubscribedTo.Global	ReSharper	EventNeverSubscribedTo.Global
EventNeverSubscribedTo.Local	ReSharper	EventNeverSubscribedTo.Local
EventUnsubscriptionViaAnonymousDelegate	ReSharper	EventUnsubscriptionViaAnonymousDelegate
ExperimentalFeature	ReSharper	ExperimentalFeature
ExplicitCallerInfoArgument	ReSharper	ExplicitCallerInfoArgument
ExpressionIsAlwaysConst	ReSharper	ExpressionIsAlwaysConst
ExpressionIsAlwaysNull	ReSharper	ExpressionIsAlwaysNull
FieldCanBeMadeReadOnly.Global	ReSharper	FieldCanBeMadeReadOnly.Global
FieldCanBeMadeReadOnly.Local	ReSharper	FieldCanBeMadeReadOnly.Local
ForCanBeConvertedToForeach	ReSharper	ForCanBeConvertedToForeach
ForStatementConditionIsTrue	ReSharper	ForStatementConditionIsTrue
ForeachCanBeConvertedToQueryUsingAnotherGetEnumerator	ReSharper	ForeachCanBeConvertedToQueryUsingAnotherGetEnumerator
ForeachCanBePartlyConvertedToQueryUsingAnotherGetEnumerator	ReSharper	ForeachCanBePartlyConvertedToQueryUsingAnotherGetEnumerator
FormatStringPlaceholdersMismatch	ReSharper	FormatStringPlaceholdersMismatch
FormatStringProblem	ReSharper	FormatStringProblem
FunctionNeverReturns	ReSharper	FunctionNeverReturns
FunctionParameterNamedArguments	ReSharper	FunctionParameterNamedArguments
FunctionRecursiveOnAllPaths	ReSharper	FunctionRecursiveOnAllPaths
FunctionUsedOutOfScope	ReSharper	FunctionUsedOutOfScope
GCSuppressFinalizeForTypeWithoutDestructor	ReSharper	GCSuppressFinalizeForTypeWithoutDestructor
GenericEnumeratorNotDisposed	ReSharper	GenericEnumeratorNotDisposed
HeuristicUnreachableCode	ReSharper	HeuristicUnreachableCode
HeuristicallyUnreachableCode	ReSharper	HeuristicallyUnreachableCode
HexColorValueWithAlpha	ReSharper	HexColorValueWithAlpha
ImplicitAnyError	ReSharper	ImplicitAnyError
ImplicitAnyTypeWarning	ReSharper	ImplicitAnyTypeWarning
ImportKeywordNotWithInvocation	ReSharper	ImportKeywordNotWithInvocation
InactivePreprocessorBranch	ReSharper	InactivePreprocessorBranch
InconsistentFunctionReturns	ReSharper	InconsistentFunctionReturns
InconsistentNaming	ReSharper	InconsistentNaming
InconsistentlySynchronizedField	ReSharper	InconsistentlySynchronizedField
IncorrectOperandInTypeOfComparison	ReSharper	IncorrectOperandInTypeOfComparison
IncorrectTripleSlashLocation	ReSharper	IncorrectTripleSlashLocation
IndexingByInvalidRange	ReSharper	IndexingByInvalidRange
InheritdocInvalidUsage	ReSharper	InheritdocInvalidUsage
InlineOutVariableDeclaration	ReSharper	InlineOutVariableDeclaration
InlineTemporaryVariable	ReSharper	InlineTemporaryVariable
IntDivisionByZero	ReSharper	IntDivisionByZero
IntVariableOverflow	ReSharper	IntVariableOverflow
IntVariableOverflowInCheckedContext	ReSharper	IntVariableOverflowInCheckedContext
IntVariableOverflowInUncheckedContext	ReSharper	IntVariableOverflowInUncheckedContext
InternalModule	ReSharper	InternalModule
InterpolatedStringExpressionIsNotIFormattable	ReSharper	InterpolatedStringExpressionIsNotIFormattable
IntroduceOptionalParameters.Global	ReSharper	IntroduceOptionalParameters.Global
IntroduceOptionalParameters.Local	ReSharper	IntroduceOptionalParameters.Local
IntroduceVariableToApplyGuard	ReSharper	IntroduceVariableToApplyGuard
InvalidAttributeValue	ReSharper	InvalidAttributeValue
InvalidJsonSyntax	ReSharper	InvalidJsonSyntax
InvalidValue	ReSharper	InvalidValue
InvalidValueType	ReSharper	InvalidValueType
InvalidXmlDocComment	ReSharper	InvalidXmlDocComment
InvertCondition	ReSharper	InvertCondition.1
InvertIf	ReSharper	InvertIf
InvocationIsSkipped	ReSharper	InvocationIsSkipped
InvocationOfNonFunction	ReSharper	InvocationOfNonFunction
InvokeAsExtensionMethod	ReSharper	InvokeAsExtensionMethod
InvokedExpressionMaybeNonFunction	ReSharper	InvokedExpressionMaybeNonFunction
IsExpressionAlwaysFalse	ReSharper	IsExpressionAlwaysFalse
IsExpressionAlwaysOfType	ReSharper	IsExpressionAlwaysOfType
IsExpressionAlwaysTrue	ReSharper	IsExpressionAlwaysTrue
IteratorMethodResultIsIgnored	ReSharper	IteratorMethodResultIsIgnored
IteratorNeverReturns	ReSharper	IteratorNeverReturns
JoinDeclarationAndInitializer	ReSharper	JoinDeclarationAndInitializer
JoinDeclarationAndInitializerJs	ReSharper	JoinDeclarationAndInitializerJs
JoinNullCheckWithUsage	ReSharper	JoinNullCheckWithUsage
JsPathNotFound	ReSharper	JsPathNotFound
JsUnreachableCode	ReSharper	JsUnreachableCode
JsonValidationFailed	ReSharper	JsonValidationFailed
JumpMustBeInLoop	ReSharper	JumpMustBeInLoop
LValueIsExpected	ReSharper	LValueIsExpected
LabelOrSemicolonExpected	ReSharper	LabelOrSemicolonExpected
Lambda	ReSharper	Lambda
LessSpecificOverloadThanMainSignature	ReSharper	LessSpecificOverloadThanMainSignature
LexicalDeclarationNeedsBlock	ReSharper	LexicalDeclarationNeedsBlock
LocalFunctionCanBeMadeStatic	ReSharper	LocalFunctionCanBeMadeStatic
LocalFunctionHidesMethod	ReSharper	LocalFunctionHidesMethod
LocalFunctionRedefinedLater	ReSharper	LocalFunctionRedefinedLater
LocalVariableHidesMember	ReSharper	LocalVariableHidesMember
LocalizableElement	ReSharper	LocalizableElement
LongLiteralEndingLowerL	ReSharper	LongLiteralEndingLowerL
LoopCanBeConvertedToQuery	ReSharper	LoopCanBeConvertedToQuery
LoopVariableIsNeverChangedInsideLoop	ReSharper	LoopVariableIsNeverChangedInsideLoop
MathAbsMethodIsRedundant	ReSharper	MathAbsMethodIsRedundant
MathClampMinGreaterThanMax	ReSharper	MathClampMinGreaterThanMax
MeaninglessDefaultParameterValue	ReSharper	MeaninglessDefaultParameterValue
MemberCanBeMadeStatic.Global	ReSharper	MemberCanBeMadeStatic.Global
MemberCanBeMadeStatic.Local	ReSharper	MemberCanBeMadeStatic.Local
MemberCanBePrivate.Global	ReSharper	MemberCanBePrivate.Global
MemberCanBePrivate.Local	ReSharper	MemberCanBePrivate.Local
MemberCanBeProtected.Global	ReSharper	MemberCanBeProtected.Global
MemberCanBeProtected.Local	ReSharper	MemberCanBeProtected.Local
MemberHidesStaticFromOuterClass	ReSharper	MemberHidesStaticFromOuterClass
MemberInitializerValueIgnored	ReSharper	MemberInitializerValueIgnored
MergeAndPattern	ReSharper	MergeAndPattern
MergeCastWithTypeCheck	ReSharper	MergeCastWithTypeCheck
MergeConditionalExpression	ReSharper	MergeConditionalExpression
MergeIntoLogicalPattern	ReSharper	MergeIntoLogicalPattern
MergeIntoNegatedPattern	ReSharper	MergeIntoNegatedPattern
MergeIntoPattern	ReSharper	MergeIntoPattern
MergeSequentialChecks	ReSharper	MergeSequentialChecks
MethodHasAsyncOverload	ReSharper	MethodHasAsyncOverload
MethodHasAsyncOverloadWithCancellation	ReSharper	MethodHasAsyncOverloadWithCancellation
MethodOverloadWithOptionalParameter	ReSharper	MethodOverloadWithOptionalParameter
MethodSafeThis	ReSharper	MethodSafeThis
MethodSupportsCancellation	ReSharper	MethodSupportsCancellation
MissingAltAttributeInImgTag	ReSharper	MissingAltAttributeInImgTag
MissingAttribute	ReSharper	MissingAttribute
MissingBodyTag	ReSharper	MissingBodyTag
MissingHasOwnPropertyInForeach	ReSharper	MissingHasOwnPropertyInForeach
MissingHeadAndBodyTags	ReSharper	MissingHeadAndBodyTags
MissingHeadTag	ReSharper	MissingHeadTag
MissingTitleTag	ReSharper	MissingTitleTag
MisuseOfOwnerFunctionThis	ReSharper	MisuseOfOwnerFunctionThis
MoreSpecificForeachVariableTypeAvailable	ReSharper	MoreSpecificForeachVariableTypeAvailable
MoreSpecificSignatureAfterLessSpecific	ReSharper	MoreSpecificSignatureAfterLessSpecific
MultipleDeclarationsInForeach	ReSharper	MultipleDeclarationsInForeach
MultipleNullableAttributesUsage	ReSharper	MultipleNullableAttributesUsage
MultipleOrderBy	ReSharper	MultipleOrderBy
MultipleOutputTags	ReSharper	MultipleOutputTags
MultipleResolveCandidatesInText	ReSharper	MultipleResolveCandidatesInText
MustUseReturnValue	ReSharper	MustUseReturnValue
Mvc.ActionNotResolved	ReSharper	Mvc.ActionNotResolved
Mvc.AreaNotResolved	ReSharper	Mvc.AreaNotResolved
Mvc.ControllerNotResolved	ReSharper	Mvc.ControllerNotResolved
Mvc.InvalidModelType	ReSharper	Mvc.InvalidModelType
Mvc.MasterpageNotResolved	ReSharper	Mvc.MasterpageNotResolved
Mvc.PartialViewNotResolved	ReSharper	Mvc.PartialViewNotResolved
Mvc.TemplateNotResolved	ReSharper	Mvc.TemplateNotResolved
Mvc.ViewComponentNotResolved	ReSharper	Mvc.ViewComponentNotResolved
Mvc.ViewComponentViewNotResolved	ReSharper	Mvc.ViewComponentViewNotResolved
Mvc.ViewNotResolved	ReSharper	Mvc.ViewNotResolved
NativeTypePrototypeExtending	ReSharper	NativeTypePrototypeExtending
NativeTypePrototypeOverwriting	ReSharper	NativeTypePrototypeOverwriting
NegationOfRelationalPattern	ReSharper	NegationOfRelationalPattern
NegativeEqualityExpression	ReSharper	NegativeEqualityExpression
NegativeIndex	ReSharper	NegativeIndex
NestedStringInterpolation	ReSharper	NestedStringInterpolation
NonAssignedConstant	ReSharper	NonAssignedConstant
NonAtomicCompoundOperator	ReSharper	NonAtomicCompoundOperator
NonConstantEqualityExpressionHasConstantResult	ReSharper	NonConstantEqualityExpressionHasConstantResult
NonParsableElement	ReSharper	NonParsableElement
NonReadonlyMemberInGetHashCode	ReSharper	NonReadonlyMemberInGetHashCode
NonVolatileFieldInDoubleCheckLocking	ReSharper	NonVolatileFieldInDoubleCheckLocking
NotAccessedField.Global	ReSharper	NotAccessedField.Global
NotAccessedField.Local	ReSharper	NotAccessedField.Local
NotAccessedVariable	ReSharper	NotAccessedVariable
NotAllPathsReturnValue	ReSharper	NotAllPathsReturnValue
NotAssignedOutParameter	ReSharper	NotAssignedOutParameter
NotDeclaredInParentCulture	ReSharper	NotDeclaredInParentCulture
NotNullMemberIsNotInitialized	ReSharper	NotNullMemberIsNotInitialized
NotObservableAnnotationRedundancy	ReSharper	NotObservableAnnotationRedundancy
NotOverriddenInSpecificCulture	ReSharper	NotOverriddenInSpecificCulture
NotResolved	ReSharper	NotResolved
NotResolvedInText	ReSharper	NotResolvedInText
ObjectCreationAsStatement	ReSharper	ObjectCreationAsStatement
ObjectDestructuringWithoutParentheses	ReSharper	ObjectDestructuringWithoutParentheses
ObjectLiteralsAreNotCommaFree	ReSharper	ObjectLiteralsAreNotCommaFree
OlTagContainsNonLiElements	ReSharper	OlTagContainsNonLiElements
OneWayOperationContractWithReturnType	ReSharper	OneWayOperationContractWithReturnType
OperationContractWithoutServiceContract	ReSharper	OperationContractWithoutServiceContract
OperatorIsCanBeUsed	ReSharper	OperatorIsCanBeUsed
OptionalParameterHierarchyMismatch	ReSharper	OptionalParameterHierarchyMismatch
OptionalParameterRefOut	ReSharper	OptionalParameterRefOut
OtherTagsInsideScript1	ReSharper	OtherTagsInsideScript1
OtherTagsInsideScript2	ReSharper	OtherTagsInsideScript2
OtherTagsInsideUnclosedScript	ReSharper	OtherTagsInsideUnclosedScript
OutputTagRequired	ReSharper	OutputTagRequired
OverloadSignatureInferring	ReSharper	OverloadSignatureInferring
OverriddenWithEmptyValue	ReSharper	OverriddenWithEmptyValue
OverriddenWithSameValue	ReSharper	OverriddenWithSameValue
ParameterDoesntMakeAnySense	ReSharper	ParameterDoesntMakeAnySense
ParameterHidesMember	ReSharper	ParameterHidesMember
ParameterOnlyUsedForPreconditionCheck.Global	ReSharper	ParameterOnlyUsedForPreconditionCheck.Global
ParameterOnlyUsedForPreconditionCheck.Local	ReSharper	ParameterOnlyUsedForPreconditionCheck.Local
ParameterTypeCanBeEnumerable.Global	ReSharper	ParameterTypeCanBeEnumerable.Global
ParameterTypeCanBeEnumerable.Local	ReSharper	ParameterTypeCanBeEnumerable.Local
ParameterValueIsNotUsed	ReSharper	ParameterValueIsNotUsed
PartialMethodParameterNameMismatch	ReSharper	PartialMethodParameterNameMismatch
PartialMethodWithSinglePart	ReSharper	PartialMethodWithSinglePart
PartialTypeWithSinglePart	ReSharper	PartialTypeWithSinglePart
PathNotResolved	ReSharper	PathNotResolved
PatternAlwaysMatches	ReSharper	PatternAlwaysMatches
PatternAlwaysOfType	ReSharper	PatternAlwaysOfType
PatternIsAlwaysTrueOrFalse	ReSharper	PatternIsAlwaysTrueOrFalse
PatternNeverMatches	ReSharper	PatternNeverMatches
PolymorphicFieldLikeEventInvocation	ReSharper	PolymorphicFieldLikeEventInvocation
PossibleInfiniteInheritance	ReSharper	PossibleInfiniteInheritance
PossibleIntendedRethrow	ReSharper	PossibleIntendedRethrow
PossibleInterfaceMemberAmbiguity	ReSharper	PossibleInterfaceMemberAmbiguity
PossibleInvalidCastException	ReSharper	PossibleInvalidCastException
PossibleInvalidCastExceptionInForeachLoop	ReSharper	PossibleInvalidCastExceptionInForeachLoop
PossibleInvalidOperationException	ReSharper	PossibleInvalidOperationException
PossibleLossOfFraction	ReSharper	PossibleLossOfFraction
PossibleMistakenArgument	ReSharper	PossibleMistakenArgument
PossibleMistakenCallToGetType	ReSharper	PossibleMistakenCallToGetType.1
PossibleMistakenCallToGetType	ReSharper	PossibleMistakenCallToGetType.2
PossibleMultipleEnumeration	ReSharper	PossibleMultipleEnumeration
PossibleMultipleWriteAccessInDoubleCheckLocking	ReSharper	PossibleMultipleWriteAccessInDoubleCheckLocking
PossibleNullReferenceException	ReSharper	PossibleNullReferenceException
PossibleStructMemberModificationOfNonVariableStruct	ReSharper	PossibleStructMemberModificationOfNonVariableStruct
PossibleUnintendedLinearSearchInSet	ReSharper	PossibleUnintendedLinearSearchInSet
PossibleUnintendedQueryableAsEnumerable	ReSharper	PossibleUnintendedQueryableAsEnumerable
PossibleUnintendedReferenceComparison	ReSharper	PossibleUnintendedReferenceComparison
PossibleWriteToMe	ReSharper	PossibleWriteToMe
PossiblyImpureMethodCallOnReadonlyVariable	ReSharper	PossiblyImpureMethodCallOnReadonlyVariable
PossiblyIncorrectlyBrokenStatement	ReSharper	PossiblyIncorrectlyBrokenStatement
PossiblyMissingIndexerInitializerComma	ReSharper	PossiblyMissingIndexerInitializerComma
PossiblyMistakenUseOfInterpolatedStringInsert	ReSharper	PossiblyMistakenUseOfInterpolatedStringInsert
PossiblyMistakenUseOfParamsMethod	ReSharper	PossiblyMistakenUseOfParamsMethod
PossiblyUnassignedProperty	ReSharper	PossiblyUnassignedProperty
PrivateFieldCanBeConvertedToLocalVariable	ReSharper	PrivateFieldCanBeConvertedToLocalVariable
PrivateVariableCanBeMadeReadonly	ReSharper	PrivateVariableCanBeMadeReadonly
PropertyCanBeMadeInitOnly.Global	ReSharper	PropertyCanBeMadeInitOnly.Global
PropertyCanBeMadeInitOnly.Local	ReSharper	PropertyCanBeMadeInitOnly.Local
PropertyGetterCannotHaveParameters	ReSharper	PropertyGetterCannotHaveParameters
PropertyNotResolved	ReSharper	PropertyNotResolved
PropertySetterMustHaveSingleParameter	ReSharper	PropertySetterMustHaveSingleParameter
PublicConstructorInAbstractClass	ReSharper	PublicConstructorInAbstractClass
PureAttributeOnVoidMethod	ReSharper	PureAttributeOnVoidMethod
QualifiedExpressionIsNull	ReSharper	QualifiedExpressionIsNull
QualifiedExpressionMaybeNull	ReSharper	QualifiedExpressionMaybeNull
Razor.LayoutNotResolved	ReSharper	Razor.LayoutNotResolved
Razor.SectionNotResolved	ReSharper	Razor.SectionNotResolved
ReadAccessInDoubleCheckLocking	ReSharper	ReadAccessInDoubleCheckLocking
Redundant	ReSharper	Redundant
RedundantAbstractModifier	ReSharper	RedundantAbstractModifier
RedundantAlwaysMatchSubpattern	ReSharper	RedundantAlwaysMatchSubpattern
RedundantAnonymousTypePropertyName	ReSharper	RedundantAnonymousTypePropertyName
RedundantArgumentDefaultValue	ReSharper	RedundantArgumentDefaultValue
RedundantArrayCreationExpression	ReSharper	RedundantArrayCreationExpression
RedundantArrayLowerBoundSpecification	ReSharper	RedundantArrayLowerBoundSpecification
RedundantAssignment	ReSharper	RedundantAssignment
RedundantAttributeParentheses	ReSharper	RedundantAttributeParentheses
RedundantAttributeUsageProperty	ReSharper	RedundantAttributeUsageProperty
RedundantBaseConstructorCall	ReSharper	RedundantBaseConstructorCall
RedundantBaseQualifier	ReSharper	RedundantBaseQualifier
RedundantBlock	ReSharper	RedundantBlock
RedundantBoolCompare	ReSharper	RedundantBoolCompare
RedundantCaseLabel	ReSharper	RedundantCaseLabel
RedundantCast	ReSharper	RedundantCast
RedundantCatchClause	ReSharper	RedundantCatchClause
RedundantCheckBeforeAssignment	ReSharper	RedundantCheckBeforeAssignment
RedundantCollectionInitializerElementBraces	ReSharper	RedundantCollectionInitializerElementBraces
RedundantComparisonWithBoolean	ReSharper	RedundantComparisonWithBoolean
RedundantCssHack	ReSharper	RedundantCssHack
RedundantDeclarationSemicolon	ReSharper	RedundantDeclarationSemicolon
RedundantDefaultMemberInitializer	ReSharper	RedundantDefaultMemberInitializer
RedundantDelegateCreation	ReSharper	RedundantDelegateCreation
RedundantDisableWarningComment	ReSharper	RedundantDisableWarningComment
RedundantDiscardDesignation	ReSharper	RedundantDiscardDesignation
RedundantElseBlock	ReSharper	RedundantElseBlock
RedundantEmptyCaseElse	ReSharper	RedundantEmptyCaseElse
RedundantEmptyConstructor	ReSharper	RedundantEmptyConstructor
RedundantEmptyFinallyBlock	ReSharper	RedundantEmptyFinallyBlock
RedundantEmptyObjectCreationArgumentList	ReSharper	RedundantEmptyObjectCreationArgumentList
RedundantEmptyObjectOrCollectionInitializer	ReSharper	RedundantEmptyObjectOrCollectionInitializer
RedundantEmptySwitchSection	ReSharper	RedundantEmptySwitchSection
RedundantEnumerableCastCall	ReSharper	RedundantEnumerableCastCall
RedundantExplicitArrayCreation	ReSharper	RedundantExplicitArrayCreation
RedundantExplicitArraySize	ReSharper	RedundantExplicitArraySize
RedundantExplicitNullableCreation	ReSharper	RedundantExplicitNullableCreation
RedundantExplicitParamsArrayCreation	ReSharper	RedundantExplicitParamsArrayCreation
RedundantExplicitPositionalPropertyDeclaration	ReSharper	RedundantExplicitPositionalPropertyDeclaration
RedundantExplicitTupleComponentName	ReSharper	RedundantExplicitTupleComponentName
RedundantExtendsListEntry	ReSharper	RedundantExtendsListEntry
RedundantFixedPointerDeclaration	ReSharper	RedundantFixedPointerDeclaration
RedundantIfElseBlock	ReSharper	RedundantIfElseBlock
RedundantImmediateDelegateInvocation	ReSharper	RedundantImmediateDelegateInvocation
RedundantIntermediateVariable	ReSharper	RedundantIntermediateVariable
RedundantIsBeforeRelationalPattern	ReSharper	RedundantIsBeforeRelationalPattern
RedundantIteratorKeyword	ReSharper	RedundantIteratorKeyword
RedundantJumpStatement	ReSharper	RedundantJumpStatement
RedundantLambdaParameterType	ReSharper	RedundantLambdaParameterType
RedundantLambdaSignatureParentheses	ReSharper	RedundantLambdaSignatureParentheses
RedundantLocalClassName	ReSharper	RedundantLocalClassName
RedundantLocalFunctionName	ReSharper	RedundantLocalFunctionName
RedundantLogicalConditionalExpressionOperand	ReSharper	RedundantLogicalConditionalExpressionOperand
RedundantMeQualifier	ReSharper	RedundantMeQualifier
RedundantMyBaseQualifier	ReSharper	RedundantMyBaseQualifier
RedundantMyClassQualifier	ReSharper	RedundantMyClassQualifier
RedundantNameQualifier	ReSharper	RedundantNameQualifier
RedundantNotNullConstraint	ReSharper	RedundantNotNullConstraint
RedundantNullableAnnotationOnReferenceTypeConstraint	ReSharper	RedundantNullableAnnotationOnReferenceTypeConstraint
RedundantNullableAnnotationOnTypeConstraintHasNonNullableBaseType	ReSharper	RedundantNullableAnnotationOnTypeConstraintHasNonNullableBaseType
RedundantNullableAnnotationOnTypeConstraintHasNonNullableTypeKind	ReSharper	RedundantNullableAnnotationOnTypeConstraintHasNonNullableTypeKind
RedundantNullableTypeMark	ReSharper	RedundantNullableTypeMark
RedundantOverflowCheckingContext	ReSharper	RedundantOverflowCheckingContext
RedundantOverload.Global	ReSharper	RedundantOverload.Global
RedundantOverload.Local	ReSharper	RedundantOverload.Local
RedundantOverriddenMember	ReSharper	RedundantOverriddenMember
RedundantParams	ReSharper	RedundantParams
RedundantParentTypeDeclaration	ReSharper	RedundantParentTypeDeclaration
RedundantPatternParentheses	ReSharper	RedundantPatternParentheses
RedundantPropertyParentheses	ReSharper	RedundantPropertyParentheses
RedundantPropertyPatternClause	ReSharper	RedundantPropertyPatternClause
RedundantQualifier	ReSharper	RedundantQualifier
RedundantQueryOrderByAscendingKeyword	ReSharper	RedundantQueryOrderByAscendingKeyword
RedundantRangeBound	ReSharper	RedundantRangeBound
RedundantReadonlyModifier	ReSharper	RedundantReadonlyModifier
RedundantRecordBody	ReSharper	RedundantRecordBody
RedundantSetterValueParameterDeclaration	ReSharper	RedundantSetterValueParameterDeclaration
RedundantStringFormatCall	ReSharper	RedundantStringFormatCall
RedundantStringInterpolation	ReSharper	RedundantStringInterpolation
RedundantStringToCharArrayCall	ReSharper	RedundantStringToCharArrayCall
RedundantStringType	ReSharper	RedundantStringType
RedundantTernaryExpression	ReSharper	RedundantTernaryExpression
RedundantToStringCall	ReSharper	RedundantToStringCall
RedundantToStringCallForValueType	ReSharper	RedundantToStringCallForValueType
RedundantTypeArgumentsOfMethod	ReSharper	RedundantTypeArgumentsOfMethod
RedundantTypeCast	ReSharper	RedundantTypeCast
RedundantTypeCastStructural	ReSharper	RedundantTypeCastStructural
RedundantUnits	ReSharper	RedundantUnits
RedundantUnsafeContext	ReSharper	RedundantUnsafeContext
RedundantUsingDirective	ReSharper	RedundantUsingDirective
RedundantVariableTypeSpecification	ReSharper	RedundantVariableTypeSpecification
RedundantVerbatimPrefix	ReSharper	RedundantVerbatimPrefix
RedundantVerbatimStringPrefix	ReSharper	RedundantVerbatimStringPrefix
RedundantWithExpression	ReSharper	RedundantWithExpression
ReferenceEqualsWithValueType	ReSharper	ReferenceEqualsWithValueType
RegExpInspections	ReSharper	RegExpInspections
RemoveRedundantOrStatement.False	ReSharper	RemoveRedundantOrStatement.False
RemoveRedundantOrStatement.True	ReSharper	RemoveRedundantOrStatement.True
RemoveToList	ReSharper	RemoveToList.1
RemoveToList	ReSharper	RemoveToList.2
ReplaceAutoPropertyWithComputedProperty	ReSharper	ReplaceAutoPropertyWithComputedProperty
ReplaceIndicingWithArrayDestructuring	ReSharper	ReplaceIndicingWithArrayDestructuring
ReplaceIndicingWithShortHandPropertiesAfterDestructuring	ReSharper	ReplaceIndicingWithShortHandPropertiesAfterDestructuring
ReplaceObjectPatternWithVarPattern	ReSharper	ReplaceObjectPatternWithVarPattern
ReplaceSliceWithRangeIndexer	ReSharper	ReplaceSliceWithRangeIndexer
ReplaceSubstringWithRangeIndexer	ReSharper	ReplaceSubstringWithRangeIndexer
ReplaceUndefinedCheckingSeriesWithObjectDestructuring	ReSharper	ReplaceUndefinedCheckingSeriesWithObjectDestructuring
ReplaceWithDestructuringSwap	ReSharper	ReplaceWithDestructuringSwap
ReplaceWithFirstOrDefault	ReSharper	ReplaceWithFirstOrDefault.1
ReplaceWithFirstOrDefault	ReSharper	ReplaceWithFirstOrDefault.2
ReplaceWithFirstOrDefault	ReSharper	ReplaceWithFirstOrDefault.3
ReplaceWithFirstOrDefault	ReSharper	ReplaceWithFirstOrDefault.4
ReplaceWithLastOrDefault	ReSharper	ReplaceWithLastOrDefault.1
ReplaceWithLastOrDefault	ReSharper	ReplaceWithLastOrDefault.2
ReplaceWithLastOrDefault	ReSharper	ReplaceWithLastOrDefault.3
ReplaceWithLastOrDefault	ReSharper	ReplaceWithLastOrDefault.4
ReplaceWithOfType	ReSharper	ReplaceWithOfType.1
ReplaceWithOfType	ReSharper	ReplaceWithOfType.2
ReplaceWithOfType	ReSharper	ReplaceWithOfType.3
ReplaceWithOfType.Any	ReSharper	ReplaceWithOfType.Any.1
ReplaceWithOfType.Any	ReSharper	ReplaceWithOfType.Any.2
ReplaceWithOfType.Count	ReSharper	ReplaceWithOfType.Count.1
ReplaceWithOfType.Count	ReSharper	ReplaceWithOfType.Count.2
ReplaceWithOfType.First	ReSharper	ReplaceWithOfType.First.1
ReplaceWithOfType.First	ReSharper	ReplaceWithOfType.First.2
ReplaceWithOfType.FirstOrDefault	ReSharper	ReplaceWithOfType.FirstOrDefault.1
ReplaceWithOfType.FirstOrDefault	ReSharper	ReplaceWithOfType.FirstOrDefault.2
ReplaceWithOfType.Last	ReSharper	ReplaceWithOfType.Last.1
ReplaceWithOfType.Last	ReSharper	ReplaceWithOfType.Last.2
ReplaceWithOfType.LastOrDefault	ReSharper	ReplaceWithOfType.LastOrDefault.1
ReplaceWithOfType.LastOrDefault	ReSharper	ReplaceWithOfType.LastOrDefault.2
ReplaceWithOfType.LongCount	ReSharper	ReplaceWithOfType.LongCount
ReplaceWithOfType.Single	ReSharper	ReplaceWithOfType.Single.1
ReplaceWithOfType.Single	ReSharper	ReplaceWithOfType.Single.2
ReplaceWithOfType.SingleOrDefault	ReSharper	ReplaceWithOfType.SingleOrDefault.1
ReplaceWithOfType.SingleOrDefault	ReSharper	ReplaceWithOfType.SingleOrDefault.2
ReplaceWithOfType.Where	ReSharper	ReplaceWithOfType.Where
ReplaceWithSimpleAssignment.False	ReSharper	ReplaceWithSimpleAssignment.False
ReplaceWithSimpleAssignment.True	ReSharper	ReplaceWithSimpleAssignment.True
ReplaceWithSingleAssignment.False	ReSharper	ReplaceWithSingleAssignment.False
ReplaceWithSingleAssignment.True	ReSharper	ReplaceWithSingleAssignment.True
ReplaceWithSingleCallToAny	ReSharper	ReplaceWithSingleCallToAny
ReplaceWithSingleCallToCount	ReSharper	ReplaceWithSingleCallToCount
ReplaceWithSingleCallToFirst	ReSharper	ReplaceWithSingleCallToFirst
ReplaceWithSingleCallToFirstOrDefault	ReSharper	ReplaceWithSingleCallToFirstOrDefault
ReplaceWithSingleCallToLast	ReSharper	ReplaceWithSingleCallToLast
ReplaceWithSingleCallToLastOrDefault	ReSharper	ReplaceWithSingleCallToLastOrDefault
ReplaceWithSingleCallToSingle	ReSharper	ReplaceWithSingleCallToSingle
ReplaceWithSingleCallToSingleOrDefault	ReSharper	ReplaceWithSingleCallToSingleOrDefault
ReplaceWithSingleOrDefault	ReSharper	ReplaceWithSingleOrDefault.1
ReplaceWithSingleOrDefault	ReSharper	ReplaceWithSingleOrDefault.2
ReplaceWithSingleOrDefault	ReSharper	ReplaceWithSingleOrDefault.3
ReplaceWithSingleOrDefault	ReSharper	ReplaceWithSingleOrDefault.4
ReplaceWithStringIsNullOrEmpty	ReSharper	ReplaceWithStringIsNullOrEmpty
RequiredBaseTypesConflict	ReSharper	RequiredBaseTypesConflict
RequiredBaseTypesDirectConflict	ReSharper	RequiredBaseTypesDirectConflict
RequiredBaseTypesIsNotInherited	ReSharper	RequiredBaseTypesIsNotInherited
RequiresFallbackColor	ReSharper	RequiresFallbackColor
ResourceItemNotResolved	ReSharper	ResourceItemNotResolved
ResourceNotResolved	ReSharper	ResourceNotResolved
ResxNotResolved	ReSharper	ResxNotResolved
ReturnFromGlobalScopetWithValue	ReSharper	ReturnFromGlobalScopetWithValue
ReturnTypeCanBeEnumerable.Global	ReSharper	ReturnTypeCanBeEnumerable.Global
ReturnTypeCanBeEnumerable.Local	ReSharper	ReturnTypeCanBeEnumerable.Local
ReturnTypeCanBeNotNullable	ReSharper	ReturnTypeCanBeNotNullable
ReturnValueOfPureMethodIsNotUsed	ReSharper	ReturnValueOfPureMethodIsNotUsed
RouteTemplates.ActionRoutePrefixCanBeExtractedToControllerRoute	ReSharper	RouteTemplates.ActionRoutePrefixCanBeExtractedToControllerRoute
RouteTemplates.AmbiguousMatchingConstraintConstructor	ReSharper	RouteTemplates.AmbiguousMatchingConstraintConstructor
RouteTemplates.AmbiguousRouteMatch	ReSharper	RouteTemplates.AmbiguousRouteMatch
RouteTemplates.ConstraintArgumentCannotBeConverted	ReSharper	RouteTemplates.ConstraintArgumentCannotBeConverted
RouteTemplates.ControllerRouteParameterIsNotPassedToMethods	ReSharper	RouteTemplates.ControllerRouteParameterIsNotPassedToMethods
RouteTemplates.DuplicatedParameter	ReSharper	RouteTemplates.DuplicatedParameter
RouteTemplates.MatchingConstraintConstructorNotResolved	ReSharper	RouteTemplates.MatchingConstraintConstructorNotResolved
RouteTemplates.MethodMissingRouteParameters	ReSharper	RouteTemplates.MethodMissingRouteParameters
RouteTemplates.OptionalParameterCanBePrecededOnlyBySinglePeriod	ReSharper	RouteTemplates.OptionalParameterCanBePrecededOnlyBySinglePeriod
RouteTemplates.OptionalParameterMustBeAtTheEndOfSegment	ReSharper	RouteTemplates.OptionalParameterMustBeAtTheEndOfSegment
RouteTemplates.ParameterConstraintCanBeSpecified	ReSharper	RouteTemplates.ParameterConstraintCanBeSpecified
RouteTemplates.ParameterTypeAndConstraintsMismatch	ReSharper	RouteTemplates.ParameterTypeAndConstraintsMismatch
RouteTemplates.ParameterTypeCanBeMadeStricter	ReSharper	RouteTemplates.ParameterTypeCanBeMadeStricter
RouteTemplates.RouteParameterConstraintNotResolved	ReSharper	RouteTemplates.RouteParameterConstraintNotResolved
RouteTemplates.RouteParameterIsNotPassedToMethod	ReSharper	RouteTemplates.RouteParameterIsNotPassedToMethod
RouteTemplates.RouteTokenNotResolved	ReSharper	RouteTemplates.RouteTokenNotResolved
RouteTemplates.SymbolNotResolved	ReSharper	RouteTemplates.SymbolNotResolved
RouteTemplates.SyntaxError	ReSharper	RouteTemplates.SyntaxError
SafeCastIsUsedAsTypeCheck	ReSharper	SafeCastIsUsedAsTypeCheck
SameImportsWithDifferentName	ReSharper	SameImportsWithDifferentName
SameVariableAssignment	ReSharper	SameVariableAssignment
ScriptTagHasBothSrcAndContentAttributes	ReSharper	ScriptTagHasBothSrcAndContentAttributes
ScriptTagWithContentBeforeIncludes	ReSharper	ScriptTagWithContentBeforeIncludes
SealedMemberInSealedClass	ReSharper	SealedMemberInSealedClass
ServiceContractWithoutOperations	ReSharper	ServiceContractWithoutOperations
ShiftExpressionRealShiftCountIsZero	ReSharper	ShiftExpressionRealShiftCountIsZero
ShiftExpressionResultEqualsZero	ReSharper	ShiftExpressionResultEqualsZero
ShiftExpressionRightOperandNotEqualRealCount	ReSharper	ShiftExpressionRightOperandNotEqualRealCount
ShiftExpressionZeroLeftOperand	ReSharper	ShiftExpressionZeroLeftOperand
SimilarAnonymousTypeNearby	ReSharper	SimilarAnonymousTypeNearby
SimilarExpressionsComparison	ReSharper	SimilarExpressionsComparison
SimplifyConditionalOperator	ReSharper	SimplifyConditionalOperator
SimplifyConditionalTernaryExpression	ReSharper	SimplifyConditionalTernaryExpression
SimplifyIIf	ReSharper	SimplifyIIf
SimplifyLinqExpressionUseAll	ReSharper	SimplifyLinqExpressionUseAll
SimplifyLinqExpressionUseAny	ReSharper	SimplifyLinqExpressionUseAny
SpecifyACultureInStringConversionExplicitly	ReSharper	SpecifyACultureInStringConversionExplicitly
SpecifyStringComparison	ReSharper	SpecifyStringComparison
SpecifyVariableTypeExplicitly	ReSharper	SpecifyVariableTypeExplicitly
StackAllocInsideLoop	ReSharper	StackAllocInsideLoop
StatementTermination	ReSharper	StatementTermination
StaticMemberInGenericType	ReSharper	StaticMemberInGenericType
StaticMemberInitializerReferesToMemberBelow	ReSharper	StaticMemberInitializerReferesToMemberBelow
StaticProblemInText	ReSharper	StaticProblemInText
StringCompareIsCultureSpecific	ReSharper	StringCompareIsCultureSpecific.1
StringCompareIsCultureSpecific	ReSharper	StringCompareIsCultureSpecific.2
StringCompareIsCultureSpecific	ReSharper	StringCompareIsCultureSpecific.3
StringCompareIsCultureSpecific	ReSharper	StringCompareIsCultureSpecific.4
StringCompareIsCultureSpecific	ReSharper	StringCompareIsCultureSpecific.5
StringCompareIsCultureSpecific	ReSharper	StringCompareIsCultureSpecific.6
StringCompareToIsCultureSpecific	ReSharper	StringCompareToIsCultureSpecific
StringConcatenationToTemplateString	ReSharper	StringConcatenationToTemplateString
StringIndexOfIsCultureSpecific	ReSharper	StringIndexOfIsCultureSpecific.1
StringIndexOfIsCultureSpecific	ReSharper	StringIndexOfIsCultureSpecific.2
StringIndexOfIsCultureSpecific	ReSharper	StringIndexOfIsCultureSpecific.3
StringLastIndexOfIsCultureSpecific	ReSharper	StringLastIndexOfIsCultureSpecific.1
StringLastIndexOfIsCultureSpecific	ReSharper	StringLastIndexOfIsCultureSpecific.2
StringLastIndexOfIsCultureSpecific	ReSharper	StringLastIndexOfIsCultureSpecific.3
StringLiteralAsInterpolationArgument	ReSharper	StringLiteralAsInterpolationArgument
StringLiteralWrongQuotes	ReSharper	StringLiteralWrongQuotes
StructCanBeMadeReadOnly	ReSharper	StructCanBeMadeReadOnly
SuggestBaseTypeForParameter	ReSharper	SuggestBaseTypeForParameter
SuggestDiscardDeclarationVarStyle	ReSharper	SuggestDiscardDeclarationVarStyle
SuggestVarOrType_BuiltInTypes	ReSharper	SuggestVarOrType_BuiltInTypes
SuggestVarOrType_DeconstructionDeclarations	ReSharper	SuggestVarOrType_DeconstructionDeclarations
SuggestVarOrType_Elsewhere	ReSharper	SuggestVarOrType_Elsewhere
SuggestVarOrType_SimpleTypes	ReSharper	SuggestVarOrType_SimpleTypes
SuperCall	ReSharper	SuperCall
SuperCallProhibitsThis	ReSharper	SuperCallProhibitsThis
SuppressNullableWarningExpressionAsInvertedIsExpression	ReSharper	SuppressNullableWarningExpressionAsInvertedIsExpression
SuspiciousInstanceofCheck	ReSharper	SuspiciousInstanceofCheck
SuspiciousLambdaBlock	ReSharper	SuspiciousLambdaBlock
SuspiciousMathSignMethod	ReSharper	SuspiciousMathSignMethod
SuspiciousThisUsage	ReSharper	SuspiciousThisUsage
SuspiciousTypeConversion.Global	ReSharper	SuspiciousTypeConversion.Global
SuspiciousTypeofCheck	ReSharper	SuspiciousTypeofCheck
SwitchExpressionHandlesSomeKnownEnumValuesWithExceptionInDefault	ReSharper	SwitchExpressionHandlesSomeKnownEnumValuesWithExceptionInDefault
SwitchStatementForEnumMissesDefaultSection	ReSharper	SwitchStatementForEnumMissesDefaultSection
SwitchStatementHandlesSomeKnownEnumValuesWithDefault	ReSharper	SwitchStatementHandlesSomeKnownEnumValuesWithDefault
SwitchStatementMissingSomeEnumCasesNoDefault	ReSharper	SwitchStatementMissingSomeEnumCasesNoDefault
SymbolFromNotCopiedLocallyReferenceUsedWarning	ReSharper	SymbolFromNotCopiedLocallyReferenceUsedWarning
SyntaxIsNotAllowed	ReSharper	SyntaxIsNotAllowed
TailRecursiveCall	ReSharper	TailRecursiveCall
TasksNotLoaded	ReSharper	TasksNotLoaded
TernaryCanBeReplacedByItsCondition	ReSharper	TernaryCanBeReplacedByItsCondition
ThisInGlobalContext	ReSharper	ThisInGlobalContext
ThreadStaticAtInstanceField	ReSharper	ThreadStaticAtInstanceField
ThreadStaticFieldHasInitializer	ReSharper	ThreadStaticFieldHasInitializer
ThrowMustBeFollowedByExpression	ReSharper	ThrowMustBeFollowedByExpression
TooWideLocalVariableScope	ReSharper	TooWideLocalVariableScope
TryCastAlwaysSucceeds	ReSharper	TryCastAlwaysSucceeds
TryStatementsCanBeMerged	ReSharper	TryStatementsCanBeMerged
TsNotResolved	ReSharper	TsNotResolved
TsResolvedFromInaccessibleModule	ReSharper	TsResolvedFromInaccessibleModule
TypeGuardDoesntAffectAnything	ReSharper	TypeGuardDoesntAffectAnything
TypeGuardProducesNeverType	ReSharper	TypeGuardProducesNeverType
TypeParameterCanBeVariant	ReSharper	TypeParameterCanBeVariant
TypeParameterHidesTypeParamFromOuterScope	ReSharper	TypeParameterHidesTypeParamFromOuterScope
UlTagContainsNonLiElements	ReSharper	UlTagContainsNonLiElements
UnassignedField.Global	ReSharper	UnassignedField.Global
UnassignedField.Local	ReSharper	UnassignedField.Local
UnassignedGetOnlyAutoProperty	ReSharper	UnassignedGetOnlyAutoProperty
UnassignedReadonlyField	ReSharper	UnassignedReadonlyField
UnclosedScript	ReSharper	UnclosedScript
UnexpectedValue	ReSharper	UnexpectedValue
UnknownCssClass	ReSharper	UnknownCssClass
UnknownCssVariable	ReSharper	UnknownCssVariable
UnknownCssVendorExtension	ReSharper	UnknownCssVendorExtension
UnknownItemGroup	ReSharper	UnknownItemGroup
UnknownMetadata	ReSharper	UnknownMetadata
UnknownOutputParameter	ReSharper	UnknownOutputParameter
UnknownProperty	ReSharper	UnknownProperty
UnknownTarget	ReSharper	UnknownTarget
UnknownTask	ReSharper	UnknownTask
UnknownTaskAttribute	ReSharper	UnknownTaskAttribute
UnreachableCode	ReSharper	UnreachableCode
UnreachableSwitchArmDueToIntegerAnalysis	ReSharper	UnreachableSwitchArmDueToIntegerAnalysis
UnreachableSwitchCaseDueToIntegerAnalysis	ReSharper	UnreachableSwitchCaseDueToIntegerAnalysis
UnrealHeaderToolError	ReSharper	UnrealHeaderToolError
UnrealHeaderToolParserError	ReSharper	UnrealHeaderToolParserError
UnrealHeaderToolWarning	ReSharper	UnrealHeaderToolWarning
UnsafeCommaInObjectPropertiesList	ReSharper	UnsafeCommaInObjectPropertiesList
UnsupportedRequiredBaseType	ReSharper	UnsupportedRequiredBaseType
UnusedAnonymousMethodSignature	ReSharper	UnusedAnonymousMethodSignature
UnusedAutoPropertyAccessor.Global	ReSharper	UnusedAutoPropertyAccessor.Global
UnusedAutoPropertyAccessor.Local	ReSharper	UnusedAutoPropertyAccessor.Local
UnusedImportClause	ReSharper	UnusedImportClause
UnusedInheritedParameter	ReSharper	UnusedInheritedParameter
UnusedLabel	ReSharper	UnusedLabel
UnusedLocalFunction	ReSharper	UnusedLocalFunction
UnusedLocalFunction.Compiler	ReSharper	UnusedLocalFunction.Compiler
UnusedLocalFunctionParameter	ReSharper	UnusedLocalFunctionParameter
UnusedLocalFunctionReturnValue	ReSharper	UnusedLocalFunctionReturnValue
UnusedLocalImport	ReSharper	UnusedLocalImport
UnusedLocals	ReSharper	UnusedLocals
UnusedMember.Global	ReSharper	UnusedMember.Global
UnusedMember.Local	ReSharper	UnusedMember.Local
UnusedMemberHierarchy.Global	ReSharper	UnusedMemberHierarchy.Global
UnusedMemberHierarchy.Local	ReSharper	UnusedMemberHierarchy.Local
UnusedMemberInSuper.Global	ReSharper	UnusedMemberInSuper.Global
UnusedMemberInSuper.Local	ReSharper	UnusedMemberInSuper.Local
UnusedMethodReturnValue.Global	ReSharper	UnusedMethodReturnValue.Global
UnusedMethodReturnValue.Local	ReSharper	UnusedMethodReturnValue.Local
UnusedParameter	ReSharper	UnusedParameter
UnusedParameter.Global	ReSharper	UnusedParameter.Global
UnusedParameter.Local	ReSharper	UnusedParameter.Local
UnusedParameterInPartialMethod	ReSharper	UnusedParameterInPartialMethod
UnusedPositionalParameterCompiler	ReSharper	UnusedPositionalParameterCompiler
UnusedProperty	ReSharper	UnusedProperty
UnusedTupleComponentInReturnValue	ReSharper	UnusedTupleComponentInReturnValue
UnusedType.Global	ReSharper	UnusedType.Global
UnusedType.Local	ReSharper	UnusedType.Local
UnusedTypeParameter	ReSharper	UnusedTypeParameter
UnusedVariable	ReSharper	UnusedVariable
UsageOfDefinitelyUnassignedValue	ReSharper	UsageOfDefinitelyUnassignedValue
UsageOfPossiblyUnassignedValue	ReSharper	UsageOfPossiblyUnassignedValue
UseArrayCreationExpression	ReSharper	UseArrayCreationExpression.1
UseArrayCreationExpression	ReSharper	UseArrayCreationExpression.2
UseAsInsteadOfTypeCast	ReSharper	UseAsInsteadOfTypeCast
UseAwaitUsing	ReSharper	UseAwaitUsing
UseCancellationTokenForIAsyncEnumerable	ReSharper	UseCancellationTokenForIAsyncEnumerable
UseCollectionCountProperty	ReSharper	UseCollectionCountProperty
UseDeconstruction	ReSharper	UseDeconstruction
UseDeconstructionOnParameter	ReSharper	UseDeconstructionOnParameter
UseFormatSpecifierInFormatString	ReSharper	UseFormatSpecifierInFormatString
UseFormatSpecifierInInterpolation	ReSharper	UseFormatSpecifierInInterpolation
UseImplicitByValModifier	ReSharper	UseImplicitByValModifier
UseImplicitlyTypedVariableEvident	ReSharper	UseImplicitlyTypedVariableEvident
UseIndexFromEndExpression	ReSharper	UseIndexFromEndExpression
UseIndexedProperty	ReSharper	UseIndexedProperty
UseIsOperator	ReSharper	UseIsOperator.1
UseIsOperator	ReSharper	UseIsOperator.2
UseMethodAny	ReSharper	UseMethodAny.0
UseMethodAny	ReSharper	UseMethodAny.1
UseMethodAny	ReSharper	UseMethodAny.2
UseMethodAny	ReSharper	UseMethodAny.3
UseMethodAny	ReSharper	UseMethodAny.4
UseMethodIsInstanceOfType	ReSharper	UseMethodIsInstanceOfType
UseNameOfInsteadOfTypeOf	ReSharper	UseNameOfInsteadOfTypeOf
UseNameofExpression	ReSharper	UseNameofExpression
UseNegatedPatternInIsExpression	ReSharper	UseNegatedPatternInIsExpression
UseNegatedPatternMatching	ReSharper	UseNegatedPatternMatching
UseNullPropagation	ReSharper	UseNullPropagation
UseObjectOrCollectionInitializer	ReSharper	UseObjectOrCollectionInitializer
UseOfImplicitGlobalInFunctionScope	ReSharper	UseOfImplicitGlobalInFunctionScope
UseOfPossiblyUnassignedProperty	ReSharper	UseOfPossiblyUnassignedProperty
UsePatternMatching	ReSharper	UsePatternMatching
UsePositionalDeconstructionPattern	ReSharper	UsePositionalDeconstructionPattern
UseStringInterpolation	ReSharper	UseStringInterpolation
UseSwitchCasePatternVariable	ReSharper	UseSwitchCasePatternVariable
UseVerbatimString	ReSharper	UseVerbatimString
UselessBinaryOperation	ReSharper	UselessBinaryOperation
UselessComparisonToIntegralConstant	ReSharper	UselessComparisonToIntegralConstant
UsingOfReservedWord	ReSharper	UsingOfReservedWord
ValueParameterNotUsed	ReSharper	ValueParameterNotUsed
ValueRangeAttributeViolation	ReSharper	ValueRangeAttributeViolation
ValueShouldHaveUnits	ReSharper	ValueShouldHaveUnits
VariableCanBeMadeConst	ReSharper	VariableCanBeMadeConst
VariableCanBeMadeLet	ReSharper	VariableCanBeMadeLet
VariableCanBeMovedToInnerBlock	ReSharper	VariableCanBeMovedToInnerBlock
VariableCanBeNotNullable	ReSharper	VariableCanBeNotNullable
VariableHidesOuterVariable	ReSharper	VariableHidesOuterVariable
VariableUsedBeforeDeclared	ReSharper	VariableUsedBeforeDeclared
VariableUsedInInnerScopeBeforeDeclared	ReSharper	VariableUsedInInnerScopeBeforeDeclared
VariableUsedOutOfScope	ReSharper	VariableUsedOutOfScope
VbUnreachableCode	ReSharper	VbUnreachableCode
VirtualMemberCallInConstructor	ReSharper	VirtualMemberCallInConstructor
VirtualMemberNeverOverridden.Global	ReSharper	VirtualMemberNeverOverridden.Global
VirtualMemberNeverOverridden.Local	ReSharper	VirtualMemberNeverOverridden.Local
VoidMethodWithMustUseReturnValueAttribute	ReSharper	VoidMethodWithMustUseReturnValueAttribute
Web.MappedPath	ReSharper	Web.MappedPath
WebConfig.ModuleNotResolved	ReSharper	WebConfig.ModuleNotResolved
WebConfig.ModuleQualificationResolve	ReSharper	WebConfig.ModuleQualificationResolve
WebConfig.RedundantAddNamespaceTag	ReSharper	WebConfig.RedundantAddNamespaceTag
WebConfig.RedundantLocationTag	ReSharper	WebConfig.RedundantLocationTag
WebConfig.TagPrefixRedundand	ReSharper	WebConfig.TagPrefixRedundand
WebConfig.TypeNotResolved	ReSharper	WebConfig.TypeNotResolved
WebConfig.UnusedAddTag	ReSharper	WebConfig.UnusedAddTag
WebConfig.UnusedElementDueToConfigSourceAttribute	ReSharper	WebConfig.UnusedElementDueToConfigSourceAttribute
WebConfig.UnusedRemoveOrClearTag	ReSharper	WebConfig.UnusedRemoveOrClearTag
WebConfig.WebConfigPathWarning	ReSharper	WebConfig.WebConfigPathWarning
WebConfig.WrongModule	ReSharper	WebConfig.WrongModule
WithExpressionInsteadOfInitializer	ReSharper	WithExpressionInsteadOfInitializer
WrongExpressionStatement	ReSharper	WrongExpressionStatement
WrongPublicModifierSpecification	ReSharper	WrongPublicModifierSpecification
WrongRequireRelativePath	ReSharper	WrongRequireRelativePath
