ATAS	mlint	ATAS
ATCA	mlint	ATCA
ATNAS	mlint	ATNAS
ATNCA	mlint	ATNCA
ATPPI	mlint	ATPPI
ATTF	mlint	ATTF
ATTOF	mlint	ATTOF
ATUNK	mlint	ATUNK
BADNOT	mlint	BADNOT
BDOPT	mlint	BDOPT
CFERR	mlint	CFERR
CFIG	mlint	CFIG
CLSUNK	mlint	CLSUNK
COLND	mlint	COLND
DSARG	mlint	DSARG
EMGRO	mlint	EMGRO
EMLOAD	mlint	EMLOAD
EMNODEF	mlint	EMNODEF
EMNSI	mlint	EMNSI
EMSCR	mlint	EMSCR
EMTAG	mlint	EMTAG
EMTC	mlint	EMTC
EMVDF	mlint	EMVDF
EMXTR	mlint	EMXTR
ERTXT	mlint	ERTXT
FCONF	mlint	FCONF
FCONV	mlint	FCONV
FNSWA	mlint	FNSWA
GPFST	mlint	GPFST
ITERS	mlint	ITERS
MCANI	mlint	MCANI
MCAPP	mlint	MCAPP
MCASC	mlint	MCASC
MCCBD	mlint	MCCBD
MCCBS	mlint	MCCBS
MCCBU	mlint	MCCBU
MCCMC	mlint	MCCMC
MCCPE	mlint	MCCPE
MCCPI	mlint	MCCPI
MCCSOP	mlint	MCCSOP
MCCSP	mlint	MCCSP
MCDIR	mlint	MCDIR
MCEB	mlint	MCEB
MCFIL	mlint	MCFIL
MCG1I	mlint	MCG1I
MCG1O	mlint	MCG1O
MCGCP	mlint	MCGCP
MCGSA	mlint	MCGSA
MCHC	mlint	MCHC
MCHM	mlint	MCHM
MCHV1	mlint	MCHV1
MCHV2	mlint	MCHV2
MCHV3	mlint	MCHV3
MCMSP	mlint	MCMSP
MCNPN	mlint	MCNPN
MCNPR	mlint	MCNPR
MCPIN	mlint	MCPIN
MCPO	mlint	MCPO
MCPSG	mlint	MCPSG
MCS1O	mlint	MCS1O
MCS2I	mlint	MCS2I
MCSAC	mlint	MCSAC
MCSCC	mlint	MCSCC
MCSCF	mlint	MCSCF
MCSCM	mlint	MCSCM
MCSCN	mlint	MCSCN
MCSCO	mlint	MCSCO
MCSCT	mlint	MCSCT
MCSGA	mlint	MCSGA
MCSGP	mlint	MCSGP
MCSH	mlint	MCSH
MCSNO	mlint	MCSNO
MCSUP	mlint	MCSUP
MCSV	mlint	MCSV
MCSWA	mlint	MCSWA
MCVC	mlint	MCVC
MOBSRV	mlint	MOBSRV
MTAGS	mlint	MTAGS
MTMAT	mlint	MTMAT
NCHKE	mlint	NCHKE
NCHKOS	mlint	NCHKOS
NOCLS	mlint	NOCLS
NPERS	mlint	NPERS
PFCEL	mlint	PFCEL
REDEF	mlint	REDEF
ROWLN	mlint	ROWLN
SPERR	mlint	SPERR
SPWRN	mlint	SPWRN
STCI	mlint	STCI
STCMP	mlint	STCMP
STCUL	mlint	STCUL
STISA	mlint	STISA
STLOW	mlint	STLOW
STRCL1	mlint	STRCL1
STRCLFH	mlint	STRCLFH
STRCLQT	mlint	STRCLQT
STREMP	mlint	STREMP
STRIFCND	mlint	STRIFCND
STRQUOT	mlint	STRQUOT
TWOCM	mlint	TWOCM
VTPCON	mlint	VTPCON
VTPEAL	mlint	VTPEAL
VTPUA	mlint	VTPUA
WLAST	mlint	WLAST
WTXT	mlint	WTXT
