AFADJLMS	mlint	AFADJLMS
AFAP	mlint	AFAP
AFAPRU	mlint	AFAPRU
AFBAP	mlint	AFBAP
AFBLMS	mlint	AFBLMS
AFBLMSFFT	mlint	AFBLMSFFT
AFDLMS	mlint	AFDLMS
AFFDAF	mlint	AFFDAF
AFFILTXLMS	mlint	AFFILTXLMS
AFFTF	mlint	AFFTF
AFGAL	mlint	AFGAL
AFHRLS	mlint	AFHRLS
AFHSWRLS	mlint	AFHSWRLS
AFLMS	mlint	AFLMS
AFLSL	mlint	AFLSL
AFNLMS	mlint	AFNLMS
AFPBFDAF	mlint	AFPBFDAF
AFPBUFDAF	mlint	AFPBUFDAF
AFQRDLSL	mlint	AFQRDLSL
AFQRDRLS	mlint	AFQRDRLS
AFRLS	mlint	AFRLS
AFSD	mlint	AFSD
AFSE	mlint	AFSE
AFSS	mlint	AFSS
AFSWFTF	mlint	AFSWFTF
AFSWRLS	mlint	AFSWRLS
AFTDAFDCT	mlint	AFTDAFDCT
AFTFAFDFT	mlint	AFTFAFDFT
AFUFDAF	mlint	AFUFDAF
AGROW	mlint	AGROW
ALIGN	mlint	ALIGN
AND2	mlint	AND2
ASGLU	mlint	ASGLU
ASGSL	mlint	ASGSL
BDLGI	mlint	BDLGI
BDLOG	mlint	BDLOG
BDSCA	mlint	BDSCA
BDSCI	mlint	BDSCI
BETALIK1	mlint	BETALIK1
BRKCONT	mlint	BRKCONT
BUFSIZE	mlint	BUFSIZE
CAPABLE	mlint	CAPABLE
CCAT	mlint	CCAT
CCAT1	mlint	CCAT1
CHAIN	mlint	CHAIN
CHARTEN	mlint	CHARTEN
CLALL	mlint	CLALL
CLASSREGTREE	mlint	CLASSREGTREE
CLCLS	mlint	CLCLS
CLFUNC	mlint	CLFUNC
CLJAVA	mlint	CLJAVA
CLMEX	mlint	CLMEX
COEFF	mlint	COEFF
COMFS	mlint	COMFS
COMMSCOPEED	mlint	COMMSCOPEED
COMMSCOPESP	mlint	COMMSCOPESP
COMNL	mlint	COMNL
CPROP	mlint	CPROP
CPROPLC	mlint	CPROPLC
CRNR	mlint	CRNR
CRNRM	mlint	CRNRM
CTORO	mlint	CTORO
CTPCT	mlint	CTPCT
DACPR	mlint	DACPR
DAFINF	mlint	DAFINF
DAPPLUT	mlint	DAPPLUT
DAVIINF	mlint	DAVIINF
DBCHDEC	mlint	DBCHDEC
DBHENC	mlint	DBHENC
DBHMNWN	mlint	DBHMNWN
DBHRRS	mlint	DBHRRS
DBITMAX	mlint	DBITMAX
DBLKMN	mlint	DBLKMN
DBLKPRC	mlint	DBLKPRC
DBURG	mlint	DBURG
DCHBWN	mlint	DCHBWN
DCOV	mlint	DCOV
DCPTF	mlint	DCPTF
DCSHELP	mlint	DCSHELP
DDBLQD	mlint	DDBLQD
DDBMEX	mlint	DDBMEX
DDELTRI	mlint	DDELTRI
DDTRD	mlint	DDTRD
DEFNU	mlint	DEFNU
DEFSIZE	mlint	DEFSIZE
DEMLC	mlint	DEMLC
DEMLMEX	mlint	DEMLMEX
DEPBART	mlint	DEPBART
DEPGENAM	mlint	DEPGENAM
DEPLETT	mlint	DEPLETT
DEPNOE	mlint	DEPNOE
DEVCTR	mlint	DEVCTR
DEVM	mlint	DEVM
DEXIFRD	mlint	DEXIFRD
DFCNCHK	mlint	DFCNCHK
DFEATUREPARAM	mlint	DFEATUREPARAM
DFIGFLAG	mlint	DFIGFLAG
DFIRGAUSS	mlint	DFIRGAUSS
DFIRRCOS	mlint	DFIRRCOS
DFLIPDIM	mlint	DFLIPDIM
DFLTTPWN	mlint	DFLTTPWN
DFTSMTX	mlint	DFTSMTX
DGAUSSFIR	mlint	DGAUSSFIR
DGETST	mlint	DGETST
DGRAPHICSVER	mlint	DGRAPHICSVER
DGSWIN	mlint	DGSWIN
DHANN	mlint	DHANN
DHMMNG	mlint	DHMMNG
DILEVAL	mlint	DILEVAL
DIMTRNS	mlint	DIMTRNS
DINLN	mlint	DINLN
DISEQN	mlint	DISEQN
DISGVER	mlint	DISGVER
DISPLAY	mlint	DISPLAY
DISPLAYPROG	mlint	DISPLAYPROG
DISSTR	mlint	DISSTR
DKSER	mlint	DKSER
DLDPCDEC	mlint	DLDPCDEC
DLDPCENC	mlint	DLDPCENC
DMCHN	mlint	DMCHN
DMCOV	mlint	DMCOV
DMENUL	mlint	DMENUL
DMER	mlint	DMER
DMSSPEC	mlint	DMSSPEC
DMTM	mlint	DMTM
DMUSIC	mlint	DMUSIC
DNDLA	mlint	DNDLA
DNLWN	mlint	DNLWN
DNNW	mlint	DNNW
DNOANI	mlint	DNOANI
DPGUPDLG	mlint	DPGUPDLG
DPNWN	mlint	DPNWN
DPOOL	mlint	DPOOL
DPOPUP	mlint	DPOPUP
DPPSD	mlint	DPPSD
DPRDGRM	mlint	DPRDGRM
DPSD	mlint	DPSD
DPSPEC	mlint	DPSPEC
DQUAD	mlint	DQUAD
DQUADL	mlint	DQUADL
DQUADV	mlint	DQUADV
DRCOSFIR	mlint	DRCOSFIR
DRCOSFLT	mlint	DRCOSFLT
DRCOSIIR	mlint	DRCOSIIR
DRCOSINE	mlint	DRCOSINE
DRCTWN	mlint	DRCTWN
DRNDINT	mlint	DRNDINT
DRSDEC	mlint	DRSDEC
DRSENC	mlint	DRSENC
DSPS	mlint	DSPS
DSTRMT	mlint	DSTRMT
DSTRRD	mlint	DSTRRD
DSTRVCT	mlint	DSTRVCT
DSTSTR	mlint	DSTSTR
DTKYWN	mlint	DTKYWN
DTRIINT	mlint	DTRIINT
DTRIQD	mlint	DTRIQD
DTRIREP	mlint	DTRIREP
DTRNG	mlint	DTRNG
DTXTRD	mlint	DTXTRD
DTYLRWN	mlint	DTYLRWN
DUALC	mlint	DUALC
DUIGET	mlint	DUIGET
DWELCH	mlint	DWELCH
DWVFINF	mlint	DWVFINF
DWVRD	mlint	DWVRD
DWVWR	mlint	DWVWR
DYULEAR	mlint	DYULEAR
EFIND	mlint	EFIND
EQEFF	mlint	EQEFF
EVLC	mlint	EVLC
EWMAPLOT	mlint	EWMAPLOT
EXIST	mlint	EXIST
EYESCOPE	mlint	EYESCOPE
EZCNTRF	mlint	EZCNTRF
EZCONTR	mlint	EZCONTR
EZGRPH3	mlint	EZGRPH3
EZMESH	mlint	EZMESH
EZMSHC	mlint	EZMSHC
EZPLT	mlint	EZPLT
EZPLT3	mlint	EZPLT3
EZSRFC	mlint	EZSRFC
EZSURF	mlint	EZSURF
FAFD	mlint	FAFD
FALFD	mlint	FALFD
FBUILDER	mlint	FBUILDER
FCNANS	mlint	FCNANS
FDATOOL	mlint	FDATOOL
FEGLO	mlint	FEGLO
FINS	mlint	FINS
FITNAIVEBAYES	mlint	FITNAIVEBAYES
FLPST	mlint	FLPST
FLUDLR	mlint	FLUDLR
FNAN	mlint	FNAN
FNDEF	mlint	FNDEF
FNDSB	mlint	FNDSB
FREAD	mlint	FREAD
FROPT	mlint	FROPT
FROPTX	mlint	FROPTX
FSTR	mlint	FSTR
FXSET	mlint	FXSET
FXUP	mlint	FXUP
GFLD	mlint	GFLD
GRIDD	mlint	GRIDD
GTARG	mlint	GTARG
H5PGET	mlint	H5PGET
H5PSET	mlint	H5PSET
HDFGD	mlint	HDFGD
HDFSD	mlint	HDFSD
HDFSW	mlint	HDFSW
HESS	mlint	HESS
HGSTGT	mlint	HGSTGT
HOUGH	mlint	HOUGH
IJCL	mlint	IJCL
IM2BW	mlint	IM2BW
INDWT	mlint	INDWT
INDWT2	mlint	INDWT2
INTRPP	mlint	INTRPP
INUSD	mlint	INUSD
INUSL	mlint	INUSL
ISCEL	mlint	ISCEL
ISCHR	mlint	ISCHR
ISCOL	mlint	ISCOL
ISGLOB	mlint	ISGLOB
ISLOG	mlint	ISLOG
ISMAT	mlint	ISMAT
ISMT	mlint	ISMT
ISROW	mlint	ISROW
ISSTR	mlint	ISSTR
LAXES	mlint	LAXES
LEGACYMD	mlint	LEGACYMD
LEGACYTR	mlint	LEGACYTR
LEGINTPAR	mlint	LEGINTPAR
LERR	mlint	LERR
LIC3	mlint	LIC3
LINPROG	mlint	LINPROG
LNGNM	mlint	LNGNM
LOGL	mlint	LOGL
LTARG	mlint	LTARG
M3COL	mlint	M3COL
MANU	mlint	MANU
MATCH2	mlint	MATCH2
MATCH3	mlint	MATCH3
MATPOOL	mlint	MATPOOL
MCASCADE	mlint	MCASCADE
MCDECIM	mlint	MCDECIM
MCINTERP	mlint	MCINTERP
MDFLT1	mlint	MDFLT1
MDUPC	mlint	MDUPC
MEXCEP	mlint	MEXCEP
MFARROW	mlint	MFARROW
MFDECIM	mlint	MFDECIM
MFFDCM	mlint	MFFDCM
MFFINTRP	mlint	MFFINTRP
MFFTFINTERP	mlint	MFFTFINTERP
MFINTERP	mlint	MFINTERP
MFSRC	mlint	MFSRC
MFTDECIM	mlint	MFTDECIM
MHERM	mlint	MHERM
MHINTERP	mlint	MHINTERP
MIDECIM	mlint	MIDECIM
MIINTERP	mlint	MIINTERP
MINV	mlint	MINV
MIPC1	mlint	MIPC1
MIWDFDECIM	mlint	MIWDFDECIM
MIWDFINTERP	mlint	MIWDFINTERP
MLINTERP	mlint	MLINTERP
MMTC	mlint	MMTC
MNANC	mlint	MNANC
MNEFF	mlint	MNEFF
MOCUP	mlint	MOCUP
MOVIE2	mlint	MOVIE2
MRPBW	mlint	MRPBW
MSNU	mlint	MSNU
MSYSTEM	mlint	MSYSTEM
MTFA1	mlint	MTFA1
MTFA2	mlint	MTFA2
MTFB	mlint	MTFB
MTFP1	mlint	MTFP1
MTFP2	mlint	MTFP2
MTHDPOOL	mlint	MTHDPOOL
MULCC	mlint	MULCC
MXFND	mlint	MXFND
N2UNI	mlint	N2UNI
NASGU	mlint	NASGU
NBRAK	mlint	NBRAK
NCHKI	mlint	NCHKI
NCHKM	mlint	NCHKM
NCHKN	mlint	NCHKN
NCHKNO	mlint	NCHKNO
NCHKO	mlint	NCHKO
NCOMMA	mlint	NCOMMA
NDWT	mlint	NDWT
NDWT2	mlint	NDWT2
NO4LP	mlint	NO4LP
NOANS	mlint	NOANS
NOCOL	mlint	NOCOL
NOCOM	mlint	NOCOM
NODEF	mlint	NODEF
NOEFF	mlint	NOEFF
NOIN	mlint	NOIN
NOPRT	mlint	NOPRT
NOPTS	mlint	NOPTS
NOSEL	mlint	NOSEL
NOSEM	mlint	NOSEM
NOV6	mlint	NOV6
NUSED	mlint	NUSED
NVREPL	mlint	NVREPL
OBJMPOOL	mlint	OBJMPOOL
OR2	mlint	OR2
PMTMCONF	mlint	PMTMCONF
PREALL	mlint	PREALL
PRINCOMP	mlint	PRINCOMP
PROBDIST	mlint	PROBDIST
PROBDISTKERNEL	mlint	PROBDISTKERNEL
PROBDISTPARAMETRIC	mlint	PROBDISTPARAMETRIC
PROBDISTUNIVKERNEL	mlint	PROBDISTUNIVKERNEL
PROBDISTUNIVPARAM	mlint	PROBDISTUNIVPARAM
PROP	mlint	PROP
PROPLC	mlint	PROPLC
PRTCAL	mlint	PRTCAL
PSET	mlint	PSET
PSIZE	mlint	PSIZE
PUSE	mlint	PUSE
QAMDEP	mlint	QAMDEP
QDEMOD	mlint	QDEMOD
QMOD	mlint	QMOD
QUADPROG	mlint	QUADPROG
RAND	mlint	RAND
READSZ	mlint	READSZ
REPMAT	mlint	REPMAT
RGXP1	mlint	RGXP1
RHSFN	mlint	RHSFN
RMFLD	mlint	RMFLD
RMWRN	mlint	RMWRN
ROIFILL	mlint	ROIFILL
SAGROW	mlint	SAGROW
SCHART	mlint	SCHART
SEMFS	mlint	SEMFS
SEPEX	mlint	SEPEX
SETNU	mlint	SETNU
SFLD	mlint	SFLD
SHVAI	mlint	SHVAI
SLLERR	mlint	SLLERR
SLLWARN	mlint	SLLWARN
SLRTBNCH	mlint	SLRTBNCH
SMPLMODE	mlint	SMPLMODE
SPEIG	mlint	SPEIG
SPRINTFN	mlint	SPRINTFN
SPRIX	mlint	SPRIX
ST2NM	mlint	ST2NM
STCCS	mlint	STCCS
STFLD	mlint	STFLD
STNCI	mlint	STNCI
STOUT	mlint	STOUT
STRNU	mlint	STRNU
STRSZ	mlint	STRSZ
STTOK	mlint	STTOK
SUBIMGNR	mlint	SUBIMGNR
SUBSASGN	mlint	SUBSASGN
SUBSINDEX	mlint	SUBSINDEX
SUSENS	mlint	SUSENS
SVMCLASSIFY	mlint	SVMCLASSIFY
SVMSMOSET	mlint	SVMSMOSET
SVMTRAIN	mlint	SVMTRAIN
TLEV	mlint	TLEV
TNMLP	mlint	TNMLP
TREEDISP	mlint	TREEDISP
TREEFIT	mlint	TREEFIT
TREEPRUNE	mlint	TREEPRUNE
TREETEST	mlint	TREETEST
TREEVAL	mlint	TREEVAL
TRIM1	mlint	TRIM1
TRIM2	mlint	TRIM2
TRSRT	mlint	TRSRT
TRYNC	mlint	TRYNC
UDIM	mlint	UDIM
UNONC	mlint	UNONC
UNRCH	mlint	UNRCH
UNRPWR	mlint	UNRPWR
USENS	mlint	USENS
V6ON	mlint	V6ON
VALST	mlint	VALST
VARARG	mlint	VARARG
VIDREAD	mlint	VIDREAD
VUNUS	mlint	VUNUS
WAVMENU	mlint	WAVMENU
WEIBCDF	mlint	WEIBCDF
WEIBFIT	mlint	WEIBFIT
WEIBINV	mlint	WEIBINV
WEIBLIKE	mlint	WEIBLIKE
WEIBPDF	mlint	WEIBPDF
WEIBPLOT	mlint	WEIBPLOT
WEIBRND	mlint	WEIBRND
WEIBSTAT	mlint	WEIBSTAT
WINTOOL	mlint	WINTOOL
XBARPLOT	mlint	XBARPLOT
