align	tslint	align=parameters,arguments,statements
ban	tslint	ban
class-name	tslint	class-name
comment-format	tslint	comment-format=check-space
curly	tslint	curly
eofline	tslint	eofline
forin	tslint	forin
indent	tslint	indent=spaces
interface-name	tslint	interface-name
jsdoc-format	tslint	jsdoc-format
label-position	tslint	label-position
max-line-length	tslint	max-line-length=140
member-access	tslint	member-access
member-ordering	tslint	member-ordering=public-before-private,static-before-instance,variables-before-functions
no-arg	tslint	no-arg
no-bitwise	tslint	no-bitwise
no-conditional-assignment	tslint	no-conditional-assignment
no-console	tslint	no-console=debug,info,time,timeEnd,trace
no-consecutive-blank-lines	tslint	no-consecutive-blank-lines
no-construct	tslint	no-construct
no-constructor-vars	tslint	no-parameter-properties
no-debugger	tslint	no-debugger
no-duplicate-variable	tslint	no-duplicate-variable
no-shadowed-variable	tslint	no-shadowed-variable
no-empty	tslint	no-empty
no-eval	tslint	no-eval
no-inferrable-types	tslint	no-inferrable-types
no-internal-module	tslint	no-internal-module
no-require-imports	tslint	no-require-imports
no-string-literal	tslint	no-string-literal
no-switch-case-fall-through	tslint	no-switch-case-fall-through
no-trailing-whitespace	tslint	no-trailing-whitespace
no-unused-expression	tslint	no-unused-expression
no-use-before-declare	tslint	no-use-before-declare
no-var-keyword	tslint	no-var-keyword
no-var-requires	tslint	no-var-requires
one-line	tslint	one-line=check-open-brace,check-catch,check-else,check-whitespace
quotemark	tslint	quotemark=single,avoid-escape
radix	tslint	radix
semicolon	tslint	semicolon
switch-default	tslint	switch-default
trailing-comma	tslint	trailing-comma=multiline:always,singleline:never
triple-equals	tslint	triple-equals=allow-null-check
typedef	tslint	typedef=call-signature,parameter,property-declaration,variable-declaration,member-variable-declaration
typedef-whitespace	tslint	typedef-whitespace=call-signature:nospace,index-signature:nospace,parameter:nospace,property-declaration:nospace,variable-declaration:nospace
variable-name	tslint	variable-name=ban-keywords
whitespace	tslint	whitespace=check-branch,check-decl,check-operator,check-separator,check-type
no-unnecessary-type-assertion	tslint	no-unnecessary-type-assertion
promise-function-async	tslint	promise-function-async
await-promise	tslint	await-promise
no-floating-promises	tslint	no-floating-promises
no-for-in-array	tslint	no-for-in-array
no-inferred-empty-object-type	tslint	no-inferred-empty-object-type
no-unbound-method	tslint	no-unbound-method
no-unsafe-any	tslint	no-unsafe-any
no-use-before-declare	tslint	no-use-before-declare
no-void-expression	tslint	no-void-expression
restrict-plus-operands	tslint	restrict-plus-operands
strict-type-predicates	tslint	strict-type-predicates
use-default-type-parameter	tslint	use-default-type-parameter
match-default-export-name	tslint	match-default-export-name
no-boolean-literal-compare	tslint	no-boolean-literal-compare
no-unnecessary-qualifier	tslint	no-unnecessary-qualifier
return-undefined	tslint	return-undefined
strict-boolean-expressions	tslint	strict-boolean-expressions=allow-null-union,allow-undefined-union,allow-string,allow-number,allow-mix,allow-boolean-or-undefined
